"SystematicName","StandardName","briefDescription","description","chromID","ORF.start","ORF.end","chromStrand","IntronID","Introns.length","Introns.start","Introns.end","Introns.chromStrand","relative.start","relative.end"
"YAL001C","TFC3","Subunit of RNA polymerase III transcription initiation factor complex","Subunit of RNA polymerase III transcription initiation factor complex; part of TauB domain of TFIIIC that binds DNA at BoxB promoter sites of tRNA and similar genes; cooperates with Tfc6p in DNA binding; largest of six subunits of RNA polymerase III transcription initiation factor complex (TFIIIC); colocalizes with condensin at pol III genes and several ETC (“extra TFIIIC)” sites; may have a role in recruiting or stabilizing Scc2/4 and condensin on chromosomes","chrI",147594,151166,-1,"S000000001_C",89,151007,151096,-1,71,160
"YAL003W","EFB1","Translation elongation factor 1 beta","Translation elongation factor 1 beta; stimulates nucleotide exchange to regenerate EF-1 alpha-GTP for the next elongation cycle; part of the EF-1 complex, which facilitates binding of aminoacyl-tRNA to the ribosomal A site; human homolog EEF1B2 can complement yeast efb1 mutants","chrI",142174,143160,1,"S000000003_C",365,142254,142619,1,81,446
"YAL030W","SNC1","Vesicle membrane receptor protein (v-SNARE)","Vesicle membrane receptor protein (v-SNARE); involved in the fusion between Golgi-derived secretory vesicles with the plasma membrane; proposed to be involved in endocytosis; member of the synaptobrevin/VAMP family of R-type v-SNARE proteins; SNC1 has a paralog, SNC2, that arose from the whole genome duplication","chrI",87286,87752,1,"S000000028_C",112,87388,87500,1,103,215
"YBL018C","POP8","Subunit of both RNase MRP and nuclear RNase P","Subunit of both RNase MRP and nuclear RNase P; RNase MRP cleaves pre-rRNA, while nuclear RNase P cleaves tRNA precursors to generate mature 5' ends and facilitates turnover of nuclear RNAs; relocalizes to the cytosol in response to hypoxia","chrII",185998,186474,-1,"S000000114_C",74,186353,186427,-1,48,122
"YBL026W","LSM2","Lsm (Like Sm) protein","Lsm (Like Sm) protein; part of heteroheptameric complexes (Lsm2p-7p and either Lsm1p or 8p): cytoplasmic Lsm1p complex involved in mRNA decay; nuclear Lsm8p complex part of U6 snRNP and possibly involved in processing tRNA, snoRNA, and rRNA; relocalizes from nucleus to cytoplasmic foci upon DNA replication stress","chrII",170623,171038,1,"S000000122_C",127,170677,170804,1,55,182
"YBL027W","RPL19B","Ribosomal 60S subunit protein L19B","Ribosomal 60S subunit protein L19B; rpl19a and rpl19b single null mutations result in slow growth, while the double null mutation is lethal; homologous to mammalian ribosomal protein L19, no bacterial homolog; RPL19B has a paralog, RPL19A, that arose from the whole genome duplication","chrII",168423,169376,1,"S000000123_C",383,168425,168808,1,3,386
"YBL040C","ERD2","HDEL receptor","HDEL receptor; an integral membrane protein that binds to the HDEL motif in proteins destined for retention in the endoplasmic reticulum; has a role in maintenance of normal levels of ER-resident proteins","chrII",142112,142868,-1,"S000000136_C",96,142750,142846,-1,23,119
"YBL050W","SEC17","Alpha-SNAP cochaperone","Alpha-SNAP cochaperone; SNARE-complex adaptor for Sec18 (NSF) during the disassembly of postfusion cis-SNARE complexes; stimulates the ATPase activity of Sec18p; peripheral membrane protein required for vesicular transport between ER and Golgi, the 'priming' step in homotypic vacuole fusion, and autophagy; similar to mammalian alpha-SNAP","chrII",125125,126119,1,"S000000146_C",115,125155,125270,1,31,146
"YBL059C-A","CMC2","Protein involved in respiratory chain complex assembly or maintenance","Protein involved in respiratory chain complex assembly or maintenance; protein of the mitochondrial intermembrane space; contains twin Cx9C motifs that can form coiled coil-helix-coiled-coil helix fold","chrII",110125,110539,-1,"S000007488_C",84,110421,110505,-1,35,119
"YBL059W","IAI11","Putative mitochondrial protein of unknown function","Putative mitochondrial protein of unknown function; the authentic, non-tagged protein is detected in highly purified mitochondria in high-throughput studies; IAI11 has a paralog, YER093C-A, that arose from the whole genome duplication","chrII",110594,111244,1,"S000000155_C",68,110880,110948,1,287,355
"YBL087C","RPL23A","Ribosomal 60S subunit protein L23A","Ribosomal 60S subunit protein L23A; homologous to mammalian ribosomal protein L23 and bacterial L14; RPL23A has a paralog, RPL23B, that arose from the whole genome duplication","chrII",59822,60739,-1,"S000000183_C",503,60194,60697,-1,43,546
"YBL091C-A","SCS22","Protein involved in regulation of phospholipid metabolism","Protein involved in regulation of phospholipid metabolism; one of 6 proteins (Ist2p, Scs2p, Scs22p, Tcb1p, Tcb2p, Tcb3p) that connect the ER and plasma membrane (PM); regulates PM PI4P levels by controlling access of the Sac1p phosphatase to its substrate, PI4P; human VAP homolog; similar to D. melanogaster inturned protein; SWAT-GFP and mCherry fusion proteins localize to the cytosol; SCS22 has a paralog, SCS2, that arose from the whole genome duplication","chrII",46565,47180,-1,"S000007228_C",87,47059,47146,-1,35,122
"YBL111C","","Helicase-like protein encoded within the telomeric Y' element","Helicase-like protein encoded within the telomeric Y' element; relocalizes from mitochondrion to cytoplasm upon DNA replication stress","chrII",2907,5009,-1,"S000002151_C",98,4117,4215,-1,795,893
"YBR048W","RPS11B","Protein component of the small (40S) ribosomal subunit","Protein component of the small (40S) ribosomal subunit; homologous to mammalian ribosomal protein S11 and bacterial S17; RPS11B has a paralog, RPS11A, that arose from the whole genome duplication","chrII",332831,333812,1,"S000000252_C",510,332876,333386,1,46,556
"YBR062C","","Protein of unknown function that interacts with Msb2p","Protein of unknown function that interacts with Msb2p; may play a role in activation of the filamentous growth pathway","chrII",365976,366600,-1,"S000000266_C",81,366503,366584,-1,17,98
"YBR078W","ECM33","GPI-anchored protein involved in efficient glucose uptake","GPI-anchored protein involved in efficient glucose uptake; possible role in apical bud growth; GPI-anchoring on the plasma membrane crucial to function; phosphorylated in mitochondria; similar to Sps2p; ECM33 has a paralog, PST1, that arose from the whole genome duplication","chrII",393123,394742,1,"S000000282_C",329,393181,393510,1,59,388
"YBR082C","UBC4","Ubiquitin-conjugating enzyme (E2)","Ubiquitin-conjugating enzyme (E2); key E2 partner with Ubc1p for the anaphase-promoting complex (APC); mediates degradation of abnormal or excess proteins, including calmodulin and histone H3; regulates levels of DNA Polymerase-{alpha} to promote efficient and accurate DNA replication; interacts with many SCF ubiquitin protein ligases; component of the cellular stress response; UBC4 has a paralog, UBC5, that arose from the whole genome duplication","chrII",406628,407169,-1,"S000000286_C",94,407028,407122,-1,48,142
"YBR084C-A","RPL19A","Ribosomal 60S subunit protein L19A","Ribosomal 60S subunit protein L19A; rpl19a and rpl19b single null mutations result in slow growth, while the double null mutation is lethal; homologous to mammalian ribosomal protein L19, no bacterial homolog; RPL19A has a paralog, RPL19B, that arose from the whole genome duplication","chrII",414186,415261,-1,"S000002156_C",505,414754,415259,-1,3,508
"YBR090C","","Putative protein of unknown function","Putative protein of unknown function; green fluorescent protein (GFP)-fusion protein localizes to the cytoplasm and nucleus","chrII",426333,427058,-1,"S000000294_C",356,426517,426873,-1,186,542
"YBR111W-A","SUS1","Component of both the SAGA histone acetylase and TREX-2 complexes","Component of both the SAGA histone acetylase and TREX-2 complexes; interacts with RNA polymerase II; involved in mRNA export coupled transcription activation and elongation; involved in post-transcriptional tethering of active genes to the nuclear periphery and to non-nascent mRNP","chrII",462139,462579,1,"S000028510_C",69,462430,462499,1,292,361
"YBR111W-A","SUS1","Component of both the SAGA histone acetylase and TREX-2 complexes","Component of both the SAGA histone acetylase and TREX-2 complexes; interacts with RNA polymerase II; involved in mRNA export coupled transcription activation and elongation; involved in post-transcriptional tethering of active genes to the nuclear periphery and to non-nascent mRNP","chrII",462139,462579,1,"S000028510_C",79,462210,462289,1,72,151
"YBR119W","MUD1","U1 snRNP A protein","U1 snRNP A protein; homolog of human U1-A; involved in nuclear mRNA splicing","chrII",479338,480323,1,"S000000323_C",88,479346,479434,1,9,97
"YBR181C","RPS6B","Protein component of the small (40S) ribosomal subunit","Protein component of the small (40S) ribosomal subunit; homologous to mammalian ribosomal protein S6, no bacterial homolog; phosphorylated on S233 by Ypk3p in a TORC1-dependent manner, and on S232 in a TORC1/2-dependent manner by Ypk1/2/3p; RPS6B has a paralog, RPS6A, that arose from the whole genome duplication","chrII",591712,592774,-1,"S000000385_C",351,592417,592768,-1,7,358
"YBR186W","PCH2","Hexameric ring ATPase that remodels chromosome axis protein Hop1p","Hexameric ring ATPase that remodels chromosome axis protein Hop1p; nucleolar component of the pachytene checkpoint, which prevents chromosome segregation when recombination and chromosome synapsis are defective; also represses meiotic interhomolog recombination in rDNA; required for meiotic double-stranded break formation","chrII",600553,602360,1,"S000000390_C",112,602104,602216,1,1552,1664
"YBR189W","RPS9B","Protein component of the small (40S) ribosomal subunit","Protein component of the small (40S) ribosomal subunit; homologous to mammalian ribosomal protein S9 and bacterial S4; RPS9B has a paralog, RPS9A, that arose from the whole genome duplication","chrII",604508,605508,1,"S000000393_C",412,604515,604927,1,8,420
"YBR191W","RPL21A","Ribosomal 60S subunit protein L21A","Ribosomal 60S subunit protein L21A; homologous to mammalian ribosomal protein L21, no bacterial homolog; RPL21A has a paralog, RPL21B, that arose from the whole genome duplication","chrII",606270,607140,1,"S000000395_C",387,606281,606668,1,12,399
"YBR215W","HPC2","Subunit of the HIR complex","Subunit of the HIR complex; HIR is a nucleosome assembly complex involved in regulation of histone gene transcription; mutants display synthetic defects with subunits of FACT, a complex that allows passage of RNA Pol II through nucleosomes","chrII",653356,655317,1,"S000000419_C",83,653369,653452,1,14,97
"YBR219C","","Putative protein of unknown function","Putative protein of unknown function; YBR219C is not an essential gene","chrII",662499,663303,-1,"S000000423_C",420,662582,663002,-1,302,722
"YBR230C","OM14","Mitochondrial outer membrane receptor for cytosolic ribosomes","Mitochondrial outer membrane receptor for cytosolic ribosomes; integral protein of the outer membrane that interacts with the nascent chain-associated complex (NAC) bound to ribosomes, contributing to co-translational mitochondrial import; interacts with porin (Por1p) and Om45p; abundance is decreased in cells grown in glucose relative to other carbon sources","chrII",679549,680050,-1,"S000000434_C",96,679943,680039,-1,12,108
"YBR255C-A","RCF3","Mitochondrial inner membrane protein","Mitochondrial inner membrane protein; associates with respiratory chain supercomplexes III (ubiquinol-cytochrome c reductase) and IV (cytochrome c oxidase); identified by sequence comparison with hemiascomycetous yeast species","chrII",726618,727074,-1,"S000007649_C",93,726918,727011,-1,64,157
"YCL002C","","Putative protein of unknown function","Putative protein of unknown function; YCL002C is not an essential gene","chrIII",110808,111675,-1,"S000000508_C",75,111558,111633,-1,43,118
"YCL005W-A","VMA9","Vacuolar H+ ATPase subunit e of the V-ATPase V0 subcomplex","Vacuolar H+ ATPase subunit e of the V-ATPase V0 subcomplex; essential for vacuolar acidification; interacts with the V-ATPase assembly factor Vma21p in the ER; involved in V0 biogenesis","chrIII",107023,107417,1,"S000028508_C",76,107034,107110,1,12,88
"YCL005W-A","VMA9","Vacuolar H+ ATPase subunit e of the V-ATPase V0 subcomplex","Vacuolar H+ ATPase subunit e of the V-ATPase V0 subcomplex; essential for vacuolar acidification; interacts with the V-ATPase assembly factor Vma21p in the ER; involved in V0 biogenesis","chrIII",107023,107417,1,"S000028508_C",95,107192,107287,1,170,265
"YCL012C","","Protein of unknown function","Protein of unknown function; SWAT-GFP and mCherry fusion proteins localize to the endoplasmic reticulum and vacuole respectively; orthologs are present in S. bayanus, S. paradoxus and Ashbya gossypii; YCL012C is not an essential gene","chrIII",101317,101788,-1,"S000029705_C",66,101634,101700,-1,89,155
"YCR028C-A","RIM1","ssDNA-binding protein essential for mitochondrial genome maintenance","ssDNA-binding protein essential for mitochondrial genome maintenance; involved in mitochondrial DNA replication; stimulates utilization by Mip1p DNA polymerase of RNA primers synthesized by Rpo41p","chrIII",172950,173440,-1,"S000007222_C",82,173116,173198,-1,243,325
"YCR031C","RPS14A","Protein component of the small (40S) ribosomal subunit","Protein component of the small (40S) ribosomal subunit; required for ribosome assembly and 20S pre-rRNA processing; mutations confer cryptopleurine resistance; homologous to mammalian ribosomal protein S14 and bacterial S11; RPS14A has a paralog, RPS14B, that arose from the whole genome duplication","chrIII",177500,178220,-1,"S000000627_C",306,177907,178213,-1,8,314
"YCR097W","HMRA1","Silenced copy of a1 at HMR","Silenced copy of a1 at HMR; homeobox corepressor that interacts with Alpha2p to repress haploid-specific gene transcription in diploid cells","chrIII",293835,294321,1,"S000000694_C",51,294240,294291,1,406,457
"YCR097W","HMRA1","Silenced copy of a1 at HMR","Silenced copy of a1 at HMR; homeobox corepressor that interacts with Alpha2p to repress haploid-specific gene transcription in diploid cells","chrIII",293835,294321,1,"S000000694_C",53,293940,293993,1,106,159
"YDL012C","","Tail-anchored plasma membrane protein with a conserved CYSTM module","Tail-anchored plasma membrane protein with a conserved CYSTM module; possibly involved in response to stress; may contribute to non-homologous end-joining (NHEJ) based on ydl012c htz1 double null phenotype; YDL012C has a paralog, YBR016W, that arose from the whole genome duplication","chrIV",431108,431517,-1,"S000002170_C",85,431387,431472,-1,46,131
"YDL029W","ARP2","Essential component of the Arp2/3 complex","Essential component of the Arp2/3 complex; Arp2/3 is a highly conserved actin nucleation center required for the motility and integrity of actin patches; involved in endocytosis and membrane growth and polarity; required for efficient Golgi-to-ER trafficking in COPI mutants","chrIV",399340,400638,1,"S000002187_C",122,399362,399484,1,23,145
"YDL064W","UBC9","SUMO-conjugating enzyme involved in the Smt3p conjugation pathway","SUMO-conjugating enzyme involved in the Smt3p conjugation pathway; nuclear protein required for S- and M-phase cyclin degradation and mitotic control; involved in proteolysis mediated by the anaphase-promoting complex cyclosome (APCC)","chrIV",337487,338070,1,"S000002222_C",109,337525,337634,1,39,148
"YDL075W","RPL31A","Ribosomal 60S subunit protein L31A","Ribosomal 60S subunit protein L31A; associates with karyopherin Sxm1p; loss of both Rpl31p and Rpl39p confers lethality; homologous to mammalian ribosomal protein L31, no bacterial homolog; RPL31A has a paralog, RPL31B, that arose from the whole genome duplication","chrIV",322226,322988,1,"S000002233_C",420,322283,322703,1,58,478
"YDL079C","MRK1","Glycogen synthase kinase 3 (GSK-3) homolog","Glycogen synthase kinase 3 (GSK-3) homolog; one of four GSK-3 homologs in S. cerevisiae that function to activate Msn2p-dependent transcription of stress responsive genes and that function in protein degradation; MRK1 has a paralog, RIM11, that arose from the whole genome duplication","chrIV",312951,314748,-1,"S000002237_C",291,314045,314336,-1,413,704
"YDL082W","RPL13A","Ribosomal 60S subunit protein L13A","Ribosomal 60S subunit protein L13A; not essential for viability; homologous to mammalian ribosomal protein L13, no bacterial homolog; RPL13A has a paralog, RPL13B, that arose from the whole genome duplication","chrIV",308424,309388,1,"S000002240_C",364,308428,308792,1,5,369
"YDL083C","RPS16B","Protein component of the small (40S) ribosomal subunit","Protein component of the small (40S) ribosomal subunit; homologous to mammalian ribosomal protein S16 and bacterial S9; RPS16B has a paralog, RPS16A, that arose from the whole genome duplication","chrIV",306926,307789,-1,"S000002241_C",431,307334,307765,-1,25,456
"YDL108W","KIN28","Ser/Thr protein kinase and subunit of TFIIK, a TFIIH subassembly","Ser/Thr protein kinase and subunit of TFIIK, a TFIIH subassembly; phosphorylates the C-terminal domain (CTD) of RNAPII (Ser5 and Ser7); facilitates recruitment of mRNA 5'-capping and polyadenylation factors to the RNAPII holoenzyme complex; minor role in RNAPII transcription; role in RNAPI transcription; regulates Atg1p kinase complex assembly during nitrogen starvation induced autophagy; associates with cyclin Ccl1p; relocalizes to the cytosol in response to hypoxia; ortholog of human CDK7","chrIV",267698,268699,1,"S000002266_C",80,267726,267806,1,29,109
"YDL115C","IWR1","RNA polymerase II transport factor, conserved from yeast to humans","RNA polymerase II transport factor, conserved from yeast to humans; also has a role in transporting RNA polymerase III into the nucleus; interacts with most of the RNAP II subunits; nucleo-cytoplasmic shuttling protein; deletion causes hypersensitivity to K1 killer toxin; protein increases in abundance and relocalizes from nucleus to cytoplasm upon DNA replication stress","chrIV",253995,255126,-1,"S000002273_C",69,254975,255044,-1,83,152
"YDL125C","HNT1","Adenosine 5'-monophosphoramidase","Adenosine 5'-monophosphoramidase; interacts physically and genetically with Kin28p, a CDK and TFIIK subunit, and genetically with CAK1; member of histidine triad (HIT) superfamily of nucleotide-binding proteins; protein abundance increases in response to DNA replication stress; human homolog HINT1 can complement yeast hnt1 mutant","chrIV",239019,239606,-1,"S000002283_C",110,239399,239509,-1,98,208
"YDL130W","RPP1B","Ribosomal protein P1 beta","Ribosomal protein P1 beta; component of the ribosomal stalk, which is involved in interaction of translational elongation factors with ribosome; free (non-ribosomal) P1 stimulates the phosphorylation of the eIF2 alpha subunit (Sui2p) by Gcn2p; accumulation is regulated by phosphorylation and interaction with the P2 stalk component","chrIV",229906,230527,1,"S000002288_C",300,230020,230320,1,115,415
"YDL136W","RPL35B","Ribosomal 60S subunit protein L35B","Ribosomal 60S subunit protein L35B; homologous to mammalian ribosomal protein L35 and bacterial L29; RPL35B has a paralog, RPL35A, that arose from the whole genome duplication","chrIV",217600,218367,1,"S000002295_C",404,217603,218007,1,4,408
"YDL191W","RPL35A","Ribosomal 60S subunit protein L35A","Ribosomal 60S subunit protein L35A; homologous to mammalian ribosomal protein L35 and bacterial L29; RPL35A has a paralog, RPL35B, that arose from the whole genome duplication","chrIV",117664,118517,1,"S000002350_C",490,117667,118157,1,4,494
"YDL219W","DTD1","D-Tyr-tRNA(Tyr) deacylase","D-Tyr-tRNA(Tyr) deacylase; functions in protein translation, may affect nonsense suppression via alteration of the protein synthesis machinery; ubiquitous among eukaryotes","chrIV",65242,65765,1,"S000002378_C",70,65307,65377,1,66,136
"YDR005C","MAF1","Highly conserved negative regulator of RNA polymerase III","Highly conserved negative regulator of RNA polymerase III; involved in tRNA processing and stability; inhibits tRNA degradation via rapid tRNA decay (RTD) pathway; binds N-terminal domain of Rpc160p subunit of Pol III to prevent closed-complex formation; regulated by phosphorylation mediated by TORC1, protein kinase A, Sch9p, casein kinase 2; localizes to cytoplasm during vegetative growth and translocates to nucleus and nucleolus under stress conditions","chrIV",456836,458103,-1,"S000002412_C",79,458018,458097,-1,7,86
"YDR025W","RPS11A","Protein component of the small (40S) ribosomal subunit","Protein component of the small (40S) ribosomal subunit; homologous to mammalian ribosomal protein S11 and bacterial S17; N-terminally propionylated in vivo; RPS11A has a paralog, RPS11B, that arose from the whole genome duplication","chrIV",491515,492324,1,"S000002432_C",338,491560,491898,1,46,384
"YDR059C","UBC5","Ubiquitin-conjugating enzyme","Ubiquitin-conjugating enzyme; mediates selective degradation of short-lived, abnormal, or excess proteins, including histone H3; central component of the cellular stress response; expression is heat inducible; protein abundance increases in response to DNA replication stress; UBC5 has a paralog, UBC4, that arose from the whole genome duplication","chrIV",569234,569770,-1,"S000002466_C",89,569634,569723,-1,48,137
"YDR064W","RPS13","Protein component of the small (40S) ribosomal subunit","Protein component of the small (40S) ribosomal subunit; homologous to mammalian ribosomal protein S13 and bacterial S15","chrIV",579458,580452,1,"S000002471_C",538,579479,580017,1,22,560
"YDR092W","UBC13","E2 ubiquitin-conjugating enzyme","E2 ubiquitin-conjugating enzyme; involved in the error-free DNA postreplication repair pathway; interacts with Mms2p to assemble ubiquitin chains at the Ub Lys-63 residue; DNA damage triggers redistribution from the cytoplasm to the nucleus","chrIV",629876,630605,1,"S000002499_C",267,629906,630173,1,31,298
"YDR129C","SAC6","Fimbrin, actin-bundling protein","Fimbrin, actin-bundling protein; cooperates with Scp1p in organization and maintenance of the actin cytoskeleton; phosphorylated by Cdc28p/Clb2p in metaphase on T103, to regulate conformation, and modulate actin filament binding affinity and actin cable dynamics; relocalizes from the plasma membrane to the cytoplasm upon DNA replication stress; human homologs PLS3 and LCP1 implicated in spinocerebellar ataxia type 2 (SCA2) can each complement yeast null mutant","chrIV",713340,715379,-1,"S000002536_C",110,715248,715358,-1,22,132
"YDR139C","RUB1","Ubiquitin-like protein with similarity to mammalian NEDD8","Ubiquitin-like protein with similarity to mammalian NEDD8; conjugation (neddylation) substrates include the cullins Cdc53p, Rtt101p, and Cul3p; activated by Ula1p and Uba3p (E1 enzyme pair); conjugation mediated by Ubc12p (E2 enzyme)","chrIV",733618,733924,-1,"S000002546_C",72,733703,733775,-1,150,222
"YDR305C","HNT2","Dinucleoside triphosphate hydrolase","Dinucleoside triphosphate hydrolase; has similarity to the tumor suppressor FHIT and belongs to the histidine triad (HIT) superfamily of nucleotide-binding proteins","chrIV",1072746,1073488,-1,"S000002713_C",88,1073313,1073401,-1,88,176
"YDR318W","MCM21","Component of the kinetochore sub-complex COMA","Component of the kinetochore sub-complex COMA; COMA (Ctf19p, Okp1p, Mcm21p, Ame1p) bridges kinetochore subunits in contact with centromeric DNA with subunits bound to microtubules during kinetochore assembly; involved in minichromosome maintenance; modified by sumoylation; orthologous to human centromere constitutive-associated network (CCAN) subunit CENP-O and fission yeast mal2","chrIV",1103758,1104947,1,"S000002726_C",82,1103810,1103892,1,53,135
"YDR367W","KEI1","Component of inositol phosphorylceramide (IPC) synthase","Component of inositol phosphorylceramide (IPC) synthase; forms a complex with Aur1p and regulates its activity; required for IPC synthase complex localization to the Golgi; post-translationally processed by Kex2p; KEI1 is an essential gene","chrIV",1212848,1213614,1,"S000002775_C",100,1212878,1212978,1,31,131
"YDR381C-A","COI1","Mitochondrial assembly factor","Mitochondrial assembly factor; important for assembly of the mitochondrial respiratory chain bc1 complex (complex III), cytochrome oxidase (complex IV), and the complex III-complex IV supercomplex; embedded in the mitochondrial inner membrane, facing the intermembrane space","chrIV",1238312,1238850,-1,"S000007650_C",193,1238631,1238824,-1,27,220
"YDR381W","YRA1","Nuclear polyadenylated RNA-binding protein","Nuclear polyadenylated RNA-binding protein; required for export of poly(A)+ mRNA from the nucleus; proposed to couple mRNA export with 3' end processing via its interactions with Mex67p and Pcf11p; interacts with DBP2; inhibits the helicase activity of Dbp2; functionally redundant with Yra2p, another REF family member","chrIV",1236558,1238004,1,"S000002789_C",765,1236843,1237608,1,286,1051
"YDR397C","NCB2","Subunit of a heterodimeric NC2 transcription regulator complex","Subunit of a heterodimeric NC2 transcription regulator complex; complex binds to TBP and can repress transcription by preventing preinitiation complex assembly or stimulate activated transcription; homologous to human NC2beta; complex also includes Bur6p","chrIV",1266366,1266898,-1,"S000002805_C",91,1266770,1266861,-1,38,129
"YDR424C","DYN2","Cytoplasmic light chain dynein, microtubule motor protein","Cytoplasmic light chain dynein, microtubule motor protein; required for intracellular transport and cell division; involved in mitotic spindle positioning; forms complex with dynein intermediate chain Pac11p that promotes Dyn1p homodimerization, potentiates motor processivity; Dyn2p-Pac11p complex important for interaction of dynein motor complex with dynactin complex; acts as molecular glue to dimerize, stabilize Nup82-Nsp1-Nup159 complex module of cytoplasmic pore filaments","chrIV",1319387,1319841,-1,"S000002832_C",79,1319618,1319697,-1,145,224
"YDR424C","DYN2","Cytoplasmic light chain dynein, microtubule motor protein","Cytoplasmic light chain dynein, microtubule motor protein; required for intracellular transport and cell division; involved in mitotic spindle positioning; forms complex with dynein intermediate chain Pac11p that promotes Dyn1p homodimerization, potentiates motor processivity; Dyn2p-Pac11p complex important for interaction of dynein motor complex with dynactin complex; acts as molecular glue to dimerize, stabilize Nup82-Nsp1-Nup159 complex module of cytoplasmic pore filaments","chrIV",1319387,1319841,-1,"S000002832_C",95,1319721,1319816,-1,26,121
"YDR447C","RPS17B","Ribosomal protein 51 (rp51) of the small (40s) subunit","Ribosomal protein 51 (rp51) of the small (40s) subunit; homologous to mammalian ribosomal protein S17, no bacterial homolog; RPS17B has a paralog, RPS17A, that arose from the whole genome duplication; protein abundance increases in response to DNA replication stress","chrIV",1354829,1355553,-1,"S000002855_C",313,1355237,1355550,-1,4,317
"YDR450W","RPS18A","Protein component of the small (40S) ribosomal subunit","Protein component of the small (40S) ribosomal subunit; homologous to mammalian ribosomal protein S18 and bacterial S13; RPS18A has a paralog, RPS18B, that arose from the whole genome duplication; protein increases in abundance and relocalizes from cytoplasm to nuclear foci upon DNA replication stress","chrIV",1359923,1360798,1,"S000002858_C",434,1359970,1360404,1,48,482
"YDR471W","RPL27B","Ribosomal 60S subunit protein L27B","Ribosomal 60S subunit protein L27B; homologous to mammalian ribosomal protein L27, no bacterial homolog; RPL27B has a paralog, RPL27A, that arose from the whole genome duplication","chrIV",1401770,1402564,1,"S000002879_C",383,1401801,1402184,1,32,415
"YDR500C","RPL37B","Ribosomal 60S subunit protein L37B","Ribosomal 60S subunit protein L37B; required for processing of 27SB pre-rRNA and formation of stable 66S assembly intermediates; protein abundance increases in response to DNA replication stress; homologous to mammalian ribosomal protein L37, no bacterial homolog; RPL37B has a paralog, RPL37A, that arose from the whole genome duplication","chrIV",1450198,1450853,-1,"S000002908_C",388,1450458,1450846,-1,8,396
"YDR535C","","Dubious open reading frame","Dubious open reading frame; unlikely to encode a functional protein, based on available experimental and comparative sequence data; YDR535C is not an essential gene","chrIV",1506606,1507362,-1,"S000002943_C",255,1507059,1507314,-1,49,304
"YEL003W","GIM4","Subunit of the heterohexameric cochaperone prefoldin complex","Subunit of the heterohexameric cochaperone prefoldin complex; complex binds specifically to cytosolic chaperonin and transfers target proteins to it","chrV",148176,148599,1,"S000000729_C",87,148195,148282,1,20,107
"YEL012W","UBC8","Ubiquitin-conjugating enzyme that regulates gluconeogenesis","Ubiquitin-conjugating enzyme that regulates gluconeogenesis; negatively regulates gluconeogenesis by mediating the glucose-induced ubiquitination of fructose-1,6-bisphosphatase (FBPase); cytoplasmic enzyme that catalyzes the ubiquitination of histones in vitro","chrV",131772,132551,1,"S000000738_C",122,131777,131899,1,6,128
"YEL076C-A","","Putative protein of unknown function","Putative protein of unknown function","chrV",4185,5114,-1,"S000002955_C",278,4323,4601,-1,514,792
"YER003C","PMI40","Mannose-6-phosphate isomerase","Mannose-6-phosphate isomerase; catalyzes the interconversion of fructose-6-P and mannose-6-P; required for early steps in protein mannosylation","chrV",157736,159118,-1,"S000000805_C",92,158995,159087,-1,32,124
"YER007C-A","TMA20","Protein of unknown function that associates with ribosomes","Protein of unknown function that associates with ribosomes; has a putative RNA binding domain; interacts with Tma22p; null mutant exhibits translation defects; has homology to human oncogene MCT-1; protein abundance increases in response to DNA replication stress","chrV",166237,166885,-1,"S000002957_C",102,166772,166874,-1,12,114
"YER014C-A","BUD25","Protein involved in bud-site selection","Protein involved in bud-site selection; diploid mutants display a random budding pattern instead of the wild-type bipolar pattern","chrV",183731,184700,-1,"S000007590_C",507,184170,184677,-1,24,531
"YER044C-A","MEI4","Meiosis-specific protein involved in forming DSBs","Meiosis-specific protein involved in forming DSBs; involved in double-strand break (DSBs) formation during meiotic recombination; required for chromosome synapsis and production of viable spores","chrV",238460,239774,-1,"S000001954_C",87,239624,239711,-1,64,151
"YER056C-A","RPL34A","Ribosomal 60S subunit protein L34A","Ribosomal 60S subunit protein L34A; homologous to mammalian ribosomal protein L34, no bacterial homolog; RPL34A has a paralog, RPL34B, that arose from the whole genome duplication","chrV",269423,270185,-1,"S000002135_C",396,269752,270148,-1,38,434
"YER074W","RPS24A","Protein component of the small (40S) ribosomal subunit","Protein component of the small (40S) ribosomal subunit; homologous to mammalian ribosomal protein S24, no bacterial homolog; RPS24A has a paralog, RPS24B, that arose from the whole genome duplication","chrV",306323,307196,1,"S000000876_C",465,306326,306791,1,4,469
"YER074W-A","YOS1","Integral membrane protein required for ER to Golgi transport","Integral membrane protein required for ER to Golgi transport; localized to the Golgi, the ER, and COPII vesicles; interacts with Yip1p and Yif1p","chrV",307653,308123,1,"S000007651_C",101,307747,307848,1,95,196
"YER074W-A","YOS1","Integral membrane protein required for ER to Golgi transport","Integral membrane protein required for ER to Golgi transport; localized to the Golgi, the ER, and COPII vesicles; interacts with Yip1p and Yif1p","chrV",307653,308123,1,"S000007651_C",110,307957,308067,1,305,415
"YER093C-A","AIM11","Protein of unknown function","Protein of unknown function; null mutant is viable but shows increased loss of mitochondrial genome and synthetic interaction with prohibitin (phb1); contains an intron; SWAT-GFP and mCherry fusion proteins localize to the mitochondria; YER093C-A has a paralog, YBL059W, that arose from the whole genome duplication","chrV",347912,348400,-1,"S000002960_C",74,348202,348276,-1,125,199
"YER117W","RPL23B","Ribosomal 60S subunit protein L23B","Ribosomal 60S subunit protein L23B; homologous to mammalian ribosomal protein L23 and bacterial L14; RPL23B has a paralog, RPL23A, that arose from the whole genome duplication","chrV",396769,397653,1,"S000000919_C",470,396811,397281,1,43,513
"YER133W","GLC7","Type 1 S/T protein phosphatase (PP1) catalytic subunit","Type 1 S/T protein phosphatase (PP1) catalytic subunit; involved in glycogen metabolism, sporulation and mitotic progression; interacts with multiple regulatory subunits; regulates actomyosin ring formation; subunit of CPF; recruited to mating projections by Afr1p interaction; regulates nucleocytoplasmic shuttling of Hxk2p; import into the nucleus is inhibited during spindle assembly checkpoint arrest; involved in dephosphorylating Rps6a/b and Bnr1p","chrV",432495,433958,1,"S000000935_C",524,432672,433196,1,178,702
"YER179W","DMC1","Meiosis-specific recombinase required for double-strand break repair","Meiosis-specific recombinase required for double-strand break repair; also required for pairing between homologous chromosomes and for the normal morphogenesis of synaptonemal complex; binds ssDNA and dsDNA, forms helical filaments; potent inhibitor of the ATPase activity of  Srs2p helicase, blocking its ssDNA translocating motor activity and inhibiting its antirecombinase activity; stimulated by Rdh54p; homolog of Rad51p and the bacterial RecA protein ","chrV",548421,549517,1,"S000000981_C",91,548553,548644,1,133,224
"YFL031W","HAC1","Basic leucine zipper (bZIP) transcription factor (ATF/CREB1 homolog)","Basic leucine zipper (bZIP) transcription factor (ATF/CREB1 homolog); regulates the unfolded protein response, via UPRE binding, and membrane biogenesis; ER stress-induced splicing pathway triggers efficient Hac1p translation; two functional forms of Hac1p are produced; translation initiation is repressed under non-stress conditions; protein abundance increases in response to DNA replication stress","chrVI",75179,76147,1,"S000001863_C",251,75840,76091,1,662,913
"YFL034C-A","RPL22B","Ribosomal 60S subunit protein L22A","Ribosomal 60S subunit protein L22A; required for translation of long 5' UTR of IME1 mRNA and meiotic entry; autoregulates splicing of its pre-m-RNA; homologous to mammalian ribosomal protein L22, no bacterial homolog; RPL22B has a paralog, RPL22A, that arose from the whole genome duplication","chrVI",64243,64932,-1,"S000006436_C",320,64600,64920,-1,13,333
"YFL034C-B","MOB2","Activator of Cbk1p kinase","Activator of Cbk1p kinase; component of the RAM signaling network that regulates cellular polarity and morphogenesis; activation of Cbk1p facilitates the Ace2p-dependent daughter cell-specific transcription of genes involved in cell separation; similar to Mob1p","chrVI",63016,63993,-1,"S000001859_C",113,63860,63973,-1,21,134
"YFL039C","ACT1","Actin","Actin; structural protein involved in cell polarization, endocytosis, and other cytoskeletal functions; monomeric actin in the nucleus plays a role in INO80 chromatin remodeling","chrVI",53260,54696,-1,"S000001855_C",308,54378,54686,-1,11,319
"YFR024C-A","LSB3","Protein containing a C-terminal SH3 domain","Protein containing a C-terminal SH3 domain; binds Las17p, which is a homolog of human Wiskott-Aldrich Syndrome protein involved in actin patch assembly and actin polymerization; protein abundance increases in response to DNA replication stress; LSB3 has a paralog, YSC84, that arose from the whole genome duplication","chrVI",201960,203433,-1,"S000002968_C",93,203293,203386,-1,48,141
"YFR031C-A","RPL2A","Ribosomal 60S subunit protein L2A","Ribosomal 60S subunit protein L2A; homologous to mammalian ribosomal protein L2 and bacterial L2; RPL2A has a paralog, RPL2B, that arose from the whole genome duplication","chrVI",220507,221418,-1,"S000002104_C",146,221268,221414,-1,5,151
"YFR045W","MRX20","Putative mitochondrial transport protein","Putative mitochondrial transport protein; null mutant is viable, exhibits decreased levels of chitin and normal resistance to calcofluor white","chrVI",241998,242999,1,"S000001941_C",71,242010,242081,1,13,84
"YGL030W","RPL30","Ribosomal 60S subunit protein L30","Ribosomal 60S subunit protein L30; involved in pre-rRNA processing in the nucleolus; autoregulates splicing of its transcript; homologous to mammalian ribosomal protein L30, no bacterial homolog","chrVII",439091,439638,1,"S000002998_C",229,439094,439323,1,4,233
"YGL033W","HOP2","Meiosis-specific protein that localizes to chromosomes","Meiosis-specific protein that localizes to chromosomes; prevents synapsis between nonhomologous chromosomes and ensures synapsis between homologs; forms complex with Mnd1p to promote homolog pairing and meiotic double-strand break repair; heterodimer of Hop2p-Mnd1p stimulates the Dmc1p-mediated strand invasion","chrVII",435625,436401,1,"S000003001_C",61,436313,436374,1,689,750
"YGL033W","HOP2","Meiosis-specific protein that localizes to chromosomes","Meiosis-specific protein that localizes to chromosomes; prevents synapsis between nonhomologous chromosomes and ensures synapsis between homologs; forms complex with Mnd1p to promote homolog pairing and meiotic double-strand break repair; heterodimer of Hop2p-Mnd1p stimulates the Dmc1p-mediated strand invasion","chrVII",435625,436401,1,"S000003001_C",69,435680,435749,1,56,125
"YGL076C","RPL7A","Ribosomal 60S subunit protein L7A","Ribosomal 60S subunit protein L7A; required for processing of 27SA3 pre-rRNA to 27SB pre-rRNA during assembly of large ribosomal subunit; depletion leads to a turnover of pre-rRNA; contains a conserved C-terminal Nucleic acid Binding Domain (NDB2); binds to Domain II of 25S and 5.8S rRNAs; homologous to mammalian ribosomal protein L7 and bacterial L30; RPL7A has a paralog, RPL7B, that arose from the whole genome duplication","chrVII",364335,365996,-1,"S000003044_C",458,365527,365985,-1,12,470
"YGL076C","RPL7A","Ribosomal 60S subunit protein L7A","Ribosomal 60S subunit protein L7A; required for processing of 27SA3 pre-rRNA to 27SB pre-rRNA during assembly of large ribosomal subunit; depletion leads to a turnover of pre-rRNA; contains a conserved C-terminal Nucleic acid Binding Domain (NDB2); binds to Domain II of 25S and 5.8S rRNAs; homologous to mammalian ribosomal protein L7 and bacterial L30; RPL7A has a paralog, RPL7B, that arose from the whole genome duplication","chrVII",364335,365996,-1,"S000003044_C",467,364965,365432,-1,565,1032
"YGL087C","MMS2","Ubiquitin-conjugating enzyme variant","Ubiquitin-conjugating enzyme variant; involved in error-free postreplication repair; forms a heteromeric complex with Ubc13p, an active ubiquitin-conjugating enzyme; cooperates with chromatin-associated RING finger proteins, Rad18p and Rad5p; protein abundance increases in response to DNA replication stress","chrVII",346406,346904,-1,"S000003055_C",84,346809,346893,-1,12,96
"YGL103W","RPL28","Ribosomal 60S subunit protein L28","Ribosomal 60S subunit protein L28; homologous to mammalian ribosomal protein L27A and bacterial L15; may have peptidyl transferase activity; can mutate to cycloheximide resistance","chrVII",310967,311927,1,"S000003071_C",510,311016,311526,1,50,560
"YGL137W","SEC27","Essential beta'-coat protein of the COPI coatomer","Essential beta'-coat protein of the COPI coatomer; involved in ER-to-Golgi and Golgi-to-ER transport; contains WD40 domains that mediate cargo selective interactions; 45% sequence identity to mammalian beta'-COP","chrVII",249869,252738,1,"S000003105_C",199,249887,250086,1,19,218
"YGL178W","MPT5","mRNA-binding protein of the PUF family","mRNA-binding protein of the PUF family; binds to specific mRNAs, often in the 3' UTR; has broad specificity and binds to more than 1000 mRNAs (16% of the transcriptome); recruits the CCR4-NOT deadenylase complex to mRNAs along with Dhh1p and Dcp1p to promote deadenylation, decapping, and decay; also interacts with the Caf20p translational initiation repressor, affecting its mRNA target specificity","chrVII",167352,170571,1,"S000003146_C",639,167355,167994,1,4,643
"YGL183C","MND1","Protein required for recombination and meiotic nuclear division","Protein required for recombination and meiotic nuclear division; forms a complex with Hop2p, which is involved in chromosome pairing and repair of meiotic double-strand breaks","chrVII",156543,157285,-1,"S000003151_C",82,157200,157282,-1,4,86
"YGL226C-A","OST5","Zeta subunit of the oligosaccharyltransferase complex of the ER lumen","Zeta subunit of the oligosaccharyltransferase complex of the ER lumen; complex catalyzes asparagine-linked glycosylation of newly synthesized proteins","chrVII",72749,73158,-1,"S000003194_C",148,72989,73137,-1,22,170
"YGL232W","TAN1","Putative tRNA acetyltransferase","Putative tRNA acetyltransferase; RNA-binding protein required for the formation of the modified nucleoside N(4)-acetylcytidine in serine and leucine tRNAs but not required for the same modification in 18S rRNA; protein abundance increases in response to DNA replication stress","chrVII",62075,63002,1,"S000003201_C",57,62132,62189,1,58,115
"YGL251C","HFM1","Meiosis specific DNA helicase","Meiosis specific DNA helicase; involved in the conversion of double-stranded breaks to later recombination intermediates and in crossover control; catalyzes the unwinding of Holliday junctions; has ssDNA and dsDNA stimulated ATPase activity","chrVII",27921,31636,-1,"S000003220_C",151,31427,31578,-1,59,210
"YGR001C","EFM5","S-adenosylmethionine-dependent lysine methyltransferase","S-adenosylmethionine-dependent lysine methyltransferase; involved in the trimethylation of eEF1A (Tef1p/Tef2p) at lysine 79; green fluorescent protein (GFP)-fusion protein localizes to the cytoplasm; required for replication of Brome mosaic virus in budding yeast; expresses a circular RNA; originally misclassified as a N-6-adenine specific DNA methyltransferase based on sequence similarity; both Efm5p and human ortholog N6AMT2 can methylate eEF1a from either species in vitro","chrVII",497133,498034,-1,"S000003233_C",61,497938,497999,-1,36,97
"YGR001C","EFM5","S-adenosylmethionine-dependent lysine methyltransferase","S-adenosylmethionine-dependent lysine methyltransferase; involved in the trimethylation of eEF1A (Tef1p/Tef2p) at lysine 79; green fluorescent protein (GFP)-fusion protein localizes to the cytoplasm; required for replication of Brome mosaic virus in budding yeast; expresses a circular RNA; originally misclassified as a N-6-adenine specific DNA methyltransferase based on sequence similarity; both Efm5p and human ortholog N6AMT2 can methylate eEF1a from either species in vitro","chrVII",497133,498034,-1,"S000003233_C",92,497366,497458,-1,577,669
"YGR029W","ERV1","Flavin-linked sulfhydryl oxidase of the mitochondrial IMS","Flavin-linked sulfhydryl oxidase of the mitochondrial IMS; N-terminus is an intrinsically disordered domain that in the cytosol helps target Erv1p to mitochondria, and in the intermembrane space oxidizes Mia40p as part of a disulfide relay system that promotes intermembrane space retention of imported proteins; functional ortholog of human GFER (ALR); human GFER carrying N-terminal 21 amino acids of Erv1p functionally complements the lethality of the erv1 null mutation","chrVII",543553,544205,1,"S000003261_C",82,543639,543721,1,87,169
"YGR034W","RPL26B","Ribosomal 60S subunit protein L26B","Ribosomal 60S subunit protein L26B; binds to 5.8S rRNA; non-essential even when paralog is also deleted; deletion has minimal affections on ribosome biosynthesis; homologous to mammalian ribosomal protein L26 and bacterial L24; RPL26B has a paralog, RPL26A, that arose from the whole genome duplication","chrVII",555812,556672,1,"S000003266_C",476,555831,556307,1,20,496
"YGR118W","RPS23A","Ribosomal protein 28 (rp28) of the small (40S) ribosomal subunit","Ribosomal protein 28 (rp28) of the small (40S) ribosomal subunit; required for translational accuracy; homologous to mammalian ribosomal protein S23 and bacterial S12; RPS23A has a paralog, RPS23B, that arose from the whole genome duplication; deletion of both RPS23A and RPS23B is lethal","chrVII",726974,727730,1,"S000003350_C",318,727039,727357,1,66,384
"YGR183C","QCR9","Subunit 9 of ubiquinol cytochrome-c reductase (Complex III)","Subunit 9 of ubiquinol cytochrome-c reductase (Complex III); Complex III is a component of the mitochondrial inner membrane electron transport chain; required for electron transfer at the ubiquinol oxidase site of the complex","chrVII",859063,859476,-1,"S000003415_C",212,859261,859473,-1,4,216
"YGR214W","RPS0A","Ribosomal 40S subunit protein S0A","Ribosomal 40S subunit protein S0A; required for maturation of 18S rRNA along with Rps0Bp; deletion of either RPS0 gene reduces growth rate, deletion of both genes is lethal; homologous to human ribosomal protein SA and bacterial S2; RPS0A has a paralog, RPS0B, that arose from the whole genome duplication;","chrVII",920575,921788,1,"S000003446_C",454,920665,921119,1,91,545
"YGR225W","AMA1","Activator of meiotic anaphase promoting complex (APC/C)","Activator of meiotic anaphase promoting complex (APC/C); Cdc20p family member; required for initiation of spore wall assembly; required for Clb1p degradation during meiosis; prevents premature assembly of the meiosis I spindle, required for DSB induced prophase I arrest","chrVII",945145,947019,1,"S000003457_C",92,946328,946420,1,1184,1276
"YGR296W","YRF1-3","Helicase encoded by the Y' element of subtelomeric regions","Helicase encoded by the Y' element of subtelomeric regions; highly expressed in the mutants lacking the telomerase component TLC1; potentially phosphorylated by Cdc28p","chrVII",1084864,1090591,1,"S000003528_C",147,1084883,1085030,1,20,167
"YHL001W","RPL14B","Ribosomal 60S subunit protein L14B","Ribosomal 60S subunit protein L14B; homologous to mammalian ribosomal protein L14, no bacterial homolog; RPL14B has a paralog, RPL14A, that arose from the whole genome duplication; protein abundance increases in response to DNA replication stress","chrVIII",104277,105091,1,"S000000993_C",397,104406,104803,1,130,527
"YHL050C","","Putative protein of unknown function","Putative protein of unknown function; potential Cdc28p substrate","chrVIII",445,3311,-1,"S000001042_C",772,1898,2670,-1,642,1414
"YHR001W-A","QCR10","Subunit of the ubiqunol-cytochrome c oxidoreductase complex","Subunit of the ubiqunol-cytochrome c oxidoreductase complex; this complex comprises part of the mitochondrial respiratory chain; members include Cobp, Rip1p, Cyt1p, Cor1p, Qcr2p, Qcr6p, Qcr7p, Qcr8p, Qcr9p, and Qcr10p and comprises part of the mitochondrial respiratory chain","chrVIII",107826,108122,1,"S000003529_C",62,107832,107894,1,7,69
"YHR010W","RPL27A","Ribosomal 60S subunit protein L27A","Ribosomal 60S subunit protein L27A; homologous to mammalian ribosomal protein L27, no bacterial homolog; RPL27A has a paralog, RPL27B, that arose from the whole genome duplication","chrVIII",126521,127492,1,"S000001052_C",560,126552,127112,1,32,592
"YHR012W","VPS29","Subunit of the membrane-associated retromer complex","Subunit of the membrane-associated retromer complex; endosomal protein; essential for endosome-to-Golgi retrograde transport; forms a subcomplex with Vps35p and Vps26p that selects cargo proteins for endosome-to-Golgi retrieval","chrVIII",129481,130448,1,"S000001054_C",118,129529,129647,1,49,167
"YHR016C","YSC84","Actin-binding protein","Actin-binding protein; involved in bundling of actin filaments and endocytosis of actin cortical patches; activity stimulated by Las17p; contains SH3 domain similar to Rvs167p; YSC84 has a paralog, LSB3, that arose from the whole genome duplication","chrVIII",136881,138455,-1,"S000001058_C",167,138241,138408,-1,48,215
"YHR021C","RPS27B","Protein component of the small (40S) ribosomal subunit","Protein component of the small (40S) ribosomal subunit; homologous to mammalian ribosomal protein S27, no bacterial homolog; RPS27B has a paralog, RPS27A, that arose from the whole genome duplication","chrVIII",147871,148669,-1,"S000001063_C",549,148117,148666,-1,4,553
"YHR039C-A","VMA10","Subunit G of the V1 peripheral membrane domain of V-ATPase","Subunit G of the V1 peripheral membrane domain of V-ATPase; part of the electrogenic proton pump found throughout the endomembrane system; involved in vacuolar acidification; the V1 peripheral membrane domain of the vacuolar H+-ATPase (V-ATPase) has eight subunits","chrVIII",187173,187679,-1,"S000002100_C",161,187515,187676,-1,4,165
"YHR041C","SRB2","Subunit of the RNA polymerase II mediator complex","Subunit of the RNA polymerase II mediator complex; associates with core polymerase subunits to form the RNA polymerase II holoenzyme; general transcription factor involved in telomere maintenance","chrVIII",189131,189864,-1,"S000001083_C",100,189750,189850,-1,15,115
"YHR076W","PTC7","Type 2C serine/threonine protein phosphatase (PP2C)","Type 2C serine/threonine protein phosphatase (PP2C); alternatively spliced to create two mRNA isoforms; protein from spliced form localizes to the mitochondria while the one from the unspliced form is localized to the nuclear envelope; activates coenzyme Q6 biosynthesis by dephosphorylation of demethoxy-Q6 hydroxylase Coq7p","chrVIII",251101,252225,1,"S000001118_C",92,251156,251248,1,56,148
"YHR077C","NMD2","Protein involved in the nonsense-mediated mRNA decay (NMD) pathway","Protein involved in the nonsense-mediated mRNA decay (NMD) pathway; interacts with Nam7p and Upf3p; involved in telomere maintenance","chrVIII",252374,255756,-1,"S000001119_C",112,255638,255750,-1,7,119
"YHR079C-A","SAE3","Meiosis-specific protein involved in meiotic recombination","Meiosis-specific protein involved in meiotic recombination; involved in DMC1-dependent meiotic recombination; forms heterodimer with Mei5p; proposed to be an assembly factor for Dmc1p","chrVIII",262192,262553,-1,"S000001957_C",85,262355,262440,-1,114,199
"YHR097C","PAL2","Protein involved in clathrin-mediated endocytosis","Protein involved in clathrin-mediated endocytosis; green fluorescent protein (GFP)-fusion protein localizes to the cytoplasm and the nucleus; YHR097C has a paralog, PAL1, that arose from the whole genome duplication","chrVIII",297385,298609,-1,"S000001139_C",123,298361,298484,-1,126,249
"YHR101C","BIG1","Integral membrane protein of the endoplasmic reticulum","Integral membrane protein of the endoplasmic reticulum; required for normal content of cell wall beta-1,6-glucan","chrVIII",314874,315968,-1,"S000001143_C",86,315772,315858,-1,111,197
"YHR123W","EPT1","sn-1,2-diacylglycerol ethanolamine- and cholinephosphotranferase","sn-1,2-diacylglycerol ethanolamine- and cholinephosphotranferase; not essential for viability; EPT1 has a paralog, CPT1, that arose from the whole genome duplication","chrVIII",354815,356081,1,"S000001165_C",90,354865,354955,1,51,141
"YHR141C","RPL42B","Ribosomal 60S subunit protein L42B","Ribosomal 60S subunit protein L42B; required for propagation of the killer toxin-encoding M1 double-stranded RNA satellite of the L-A double-stranded RNA virus; homologous to mammalian ribosomal protein L36A, no bacterial homolog; RPL42B has a paralog, RPL42A, that arose from the whole genome duplication","chrVIII",381990,382751,-1,"S000001183_C",440,382307,382747,-1,5,445
"YHR199C-A","NBL1","Subunit of the conserved chromosomal passenger complex (CPC)","Subunit of the conserved chromosomal passenger complex (CPC); complex regulates mitotic chromosome segregation; not required for the kinase activity of the complex; mediates the interaction of Sli15p and Bir1p; other complex members are Ipl1p, Sli15p, and Bir1p","chrVIII",498571,498859,-1,"S000029704_C",66,498720,498786,-1,74,140
"YHR203C","RPS4B","Protein component of the small (40S) ribosomal subunit","Protein component of the small (40S) ribosomal subunit; homologous to mammalian ribosomal protein S4, no bacterial homolog; RPS4B has a paralog, RPS4A, that arose from the whole genome duplication","chrVIII",504476,505530,-1,"S000001246_C",268,505248,505516,-1,15,283
"YHR218W","","Helicase-like protein encoded within the telomeric Y' element","Helicase-like protein encoded within the telomeric Y' element","chrVIII",558014,559924,1,"S000001261_C",98,558616,558714,1,603,701
"YIL004C","BET1","Type II membrane protein required for vesicular transport","Type II membrane protein required for vesicular transport; required for vesicular transport between the endoplasmic reticulum and Golgi complex; v-SNARE with similarity to synaptobrevins","chrIX",347946,348505,-1,"S000001266_C",130,348364,348494,-1,12,142
"YIL018W","RPL2B","Ribosomal 60S subunit protein L2B","Ribosomal 60S subunit protein L2B; homologous to mammalian ribosomal protein L2 and bacterial L2; RPL2B has a paralog, RPL2A, that arose from the whole genome duplication; expression is upregulated at low temperatures","chrIX",316768,317932,1,"S000001280_C",399,316772,317171,1,5,404
"YIL052C","RPL34B","Ribosomal 60S subunit protein L34B","Ribosomal 60S subunit protein L34B; homologous to mammalian ribosomal protein L34, no bacterial homolog; RPL34B has a paralog, RPL34A, that arose from the whole genome duplication","chrIX",256226,257063,-1,"S000001314_C",471,256555,257026,-1,38,509
"YIL069C","RPS24B","Protein component of the small (40S) ribosomal subunit","Protein component of the small (40S) ribosomal subunit; homologous to mammalian ribosomal protein S24, no bacterial homolog; RPS24B has a paralog, RPS24A, that arose from the whole genome duplication","chrIX",231553,232369,-1,"S000001331_C",408,231958,232366,-1,4,412
"YIL073C","SPO22","Meiosis-specific protein essential for chromosome synapsis","Meiosis-specific protein essential for chromosome synapsis; involved in completion of nuclear divisions during meiosis; induced early in meiosis","chrIX",222937,225954,-1,"S000001335_C",89,225810,225899,-1,56,145
"YIL106W","MOB1","Component of the mitotic exit network","Component of the mitotic exit network; associates with and is required for the activation and Cdc15p-dependent phosphorylation of the Dbf2p kinase; required for cytokinesis and cell separation; component of the CCR4 transcriptional complex; relocalizes from cytoplasm to the nuclear periphery upon DNA replication stress","chrIX",166415,167444,1,"S000001368_C",84,166435,166519,1,21,105
"YIL111W","COX5B","Subunit Vb of cytochrome c oxidase","Subunit Vb of cytochrome c oxidase; cytochrome c oxidase is the terminal member of the mitochondrial inner membrane electron transport chain; Cox5Bp is predominantly expressed during anaerobic growth while its isoform Va (Cox5Ap) is expressed during aerobic growth; COX5B has a paralog, COX5A, that arose from the whole genome duplication","chrIX",155222,155765,1,"S000001373_C",87,155223,155310,1,2,89
"YIL133C","RPL16A","Ribosomal 60S subunit protein L16A","Ribosomal 60S subunit protein L16A; N-terminally acetylated, binds 5.8 S rRNA; transcriptionally regulated by Rap1p; homologous to mammalian ribosomal protein L13A and bacterial L13; RPL16A has a paralog, RPL16B, that arose from the whole genome duplication; protein abundance increases in response to DNA replication stress","chrIX",98527,99416,-1,"S000001395_C",289,99096,99385,-1,32,321
"YIL148W","RPL40A","Ubiquitin-ribosomal 60S subunit protein L40A fusion protein","Ubiquitin-ribosomal 60S subunit protein L40A fusion protein; cleaved to yield ubiquitin and ribosomal protein L40A; ubiquitin may facilitate assembly of the ribosomal protein into ribosomes; homologous to mammalian ribosomal protein L40, no bacterial homolog; RPL40A has a paralog, RPL40B, that arose from the whole genome duplication; relative distribution to the nucleus increases upon DNA replication stress","chrIX",68708,69528,1,"S000001410_C",433,68716,69149,1,9,442
"YIL156W-B","MCO8","Mitochondrial protein of unknown function","Mitochondrial protein of unknown function; originally identified based on homology to <i>Ashbya gossypii</i> and other related yeasts; SWAT-GFP and mCherry fusion proteins localize to the vacuole, while SWAT-GFP fusion also localizes to the endoplasmic reticulum","chrIX",47690,47973,1,"S000028511_C",61,47699,47760,1,10,71
"YIL177C","","Putative Y' element ATP-dependent helicase","Putative Y' element ATP-dependent helicase","chrIX",483,6147,-1,"S000001439_C",387,4599,4986,-1,1162,1549
"YJL001W","PRE3","Beta 1 subunit of the 20S proteasome","Beta 1 subunit of the 20S proteasome; responsible for cleavage after acidic residues in peptides","chrX",435163,435926,1,"S000003538_C",115,435228,435343,1,66,181
"YJL024C","APS3","Small subunit of the clathrin-associated adaptor complex AP-3","Small subunit of the clathrin-associated adaptor complex AP-3; involved in vacuolar protein sorting; related to the sigma subunit of the mammalian clathrin AP-3 complex; suppressor of loss of casein kinase 1 function; protein abundance increases in response to DNA replication stress","chrX",395931,396592,-1,"S000003561_C",76,396494,396570,-1,23,99
"YJL031C","BET4","Alpha subunit of Type II geranylgeranyltransferase","Alpha subunit of Type II geranylgeranyltransferase; required for vesicular transport between the endoplasmic reticulum and the Golgi; provides a membrane attachment moiety to Rab-like proteins Ypt1p and Sec4p","chrX",386368,387438,-1,"S000003568_C",86,387349,387435,-1,4,90
"YJL041W","NSP1","FG-nucleoporin component of central core of the nuclear pore complex","FG-nucleoporin component of central core of the nuclear pore complex; also part of the nuclear pore complex (NPC) nuclear basket; contributes directly to nucleocytoplasmic transport and maintenance of the NPC permeability barrier; found in stable complex with Nup82p, Gle2p and two other FG-nucleoporins (Nup159p and Nup116p); also found in stable complex with Nic96p and two other FG-nucleoproteins (Nup49p and Nup57p)","chrX",365784,368373,1,"S000003577_C",117,365785,365902,1,2,119
"YJL136C","RPS21B","Protein component of the small (40S) ribosomal subunit","Protein component of the small (40S) ribosomal subunit; homologous to mammalian ribosomal protein S21, no bacterial homolog; RPS21B has a paralog, RPS21A, that arose from the whole genome duplication","chrX",156550,157273,-1,"S000003672_C",459,156790,157249,-1,25,484
"YJL177W","RPL17B","Ribosomal 60S subunit protein L17B","Ribosomal 60S subunit protein L17B; required for processing of 27SB pre-rRNA and formation of stable 66S assembly intermediates; homologous to mammalian ribosomal protein L17 and bacterial L22; RPL17B has a paralog, RPL17A, that arose from the whole genome duplication","chrX",90786,91657,1,"S000003713_C",316,91095,91411,1,310,626
"YJL189W","RPL39","Ribosomal 60S subunit protein L39","Ribosomal 60S subunit protein L39; required for ribosome biogenesis; loss of both Rpl31p and Rpl39p confers lethality; also exhibits genetic interactions with SIS1 and PAB1; homologous to mammalian ribosomal protein L39, no bacterial homolog","chrX",75933,76474,1,"S000003725_C",385,75939,76324,1,7,392
"YJL191W","RPS14B","Protein component of the small (40S) ribosomal subunit","Protein component of the small (40S) ribosomal subunit; required for ribosome assembly and 20S pre-rRNA processing; mutations confer cryptopleurine resistance; homologous to mammalian ribosomal protein S14 and bacterial S11; RPS14B has a paralog, RPS14A, that arose from the whole genome duplication","chrX",73787,74611,1,"S000003727_C",407,73797,74204,1,11,418
"YJL205C","NCE101","Protein of unknown function","Protein of unknown function; involved in secretion of proteins that lack classical secretory signal sequences; SWAT-GFP and mCherry fusion proteins localize to the cytosol","chrX",50139,50443,-1,"S000003742_C",142,50269,50411,-1,33,175
"YJL225C","","Putative Y' element ATP-dependent helicase","Putative Y' element ATP-dependent helicase","chrX",466,6130,-1,"S000003760_C",387,4582,4969,-1,1162,1549
"YJR021C","REC107","Protein involved in early stages of meiotic recombination","Protein involved in early stages of meiotic recombination; involved in coordination between the initiation of recombination and the first division of meiosis; part of a complex (Rec107p-Mei4p-Rec114p) required for ds break formation","chrX",468555,469579,-1,"S000003782_C",79,469184,469263,-1,317,396
"YJR079W","","Putative protein of unknown function","Putative protein of unknown function; mutation results in impaired mitochondrial respiration","chrX",580205,581239,1,"S000003840_C",704,580348,581052,1,144,848
"YJR094W-A","RPL43B","Ribosomal 60S subunit protein L43B","Ribosomal 60S subunit protein L43B; homologous to mammalian ribosomal protein L37A, no bacterial homolog; RPL43B has a paralog, RPL43A, that arose from the whole genome duplication; protein abundance increases in response to DNA replication stress","chrX",608305,608858,1,"S000003855_C",274,608307,608581,1,3,277
"YJR112W-A","","Putative protein of unknown function","Putative protein of unknown function; SWAT-GFP and mCherry fusion proteins localize to the endoplasmic reticulum; identified based on homology to <i>Ashbya gossypii</i>","chrX",637790,638168,1,"S000028513_C",48,637810,637858,1,21,69
"YJR145C","RPS4A","Protein component of the small (40S) ribosomal subunit","Protein component of the small (40S) ribosomal subunit; mutation affects 20S pre-rRNA processing; homologous to mammalian ribosomal protein S4, no bacterial homolog; RPS4A has a paralog, RPS4B, that arose from the whole genome duplication","chrX",702027,703068,-1,"S000003906_C",255,702799,703054,-1,15,270
"YKL002W","DID4","Class E Vps protein of the ESCRT-III complex","Class E Vps protein of the ESCRT-III complex; required for sorting of integral membrane proteins into lumenal vesicles of multivesicular bodies, and for delivery of newly synthesized vacuolar enzymes to the vacuole, involved in endocytosis","chrXI",437778,438544,1,"S000001485_C",67,437838,437905,1,61,128
"YKL006C-A","SFT1","Intra-Golgi v-SNARE","Intra-Golgi v-SNARE; required for transport of proteins between an early and a later Golgi compartment","chrXI",430198,430632,-1,"S000002101_C",140,430456,430596,-1,37,177
"YKL006W","RPL14A","Ribosomal 60S subunit protein L14A","Ribosomal 60S subunit protein L14A; N-terminally acetylated; homologous to mammalian ribosomal protein L14, no bacterial homolog; RPL14A has a paralog, RPL14B, that arose from the whole genome duplication","chrXI",431906,432720,1,"S000001489_C",397,432035,432432,1,130,527
"YKL081W","TEF4","Gamma subunit of translational elongation factor eEF1B","Gamma subunit of translational elongation factor eEF1B; stimulates the binding of aminoacyl-tRNA (AA-tRNA) to ribosomes by releasing eEF1A (Tef1p/Tef2p) from the ribosomal complex","chrXI",282891,284455,1,"S000001564_C",325,283096,283421,1,206,531
"YKL156W","RPS27A","Protein component of the small (40S) ribosomal subunit","Protein component of the small (40S) ribosomal subunit; homologous to mammalian ribosomal protein S27, no bacterial homolog; RPS27A has a paralog, RPS27B, that arose from the whole genome duplication; protein abundance increases in response to DNA replication stress","chrXI",158613,159212,1,"S000001639_C",350,158616,158966,1,4,354
"YKL157W","APE2","Aminopeptidase yscII","Aminopeptidase yscII; may have a role in obtaining leucine from dipeptide substrates; APE2 has a paralog, AAP1, that arose from the whole genome duplication","chrXI",154991,158232,1,"S000001640_C",382,155272,155654,1,282,664
"YKL180W","RPL17A","Ribosomal 60S subunit protein L17A","Ribosomal 60S subunit protein L17A; required for processing of 27SB pre-rRNA and formation of stable 66S assembly intermediates; copurifies with the Dam1 complex (aka DASH complex); homologous to mammalian ribosomal protein L17 and bacterial L22; RPL17A has a paralog, RPL17B, that arose from the whole genome duplication; protein abundance increases in response to DNA replication stress","chrXI",109269,110129,1,"S000001663_C",305,109578,109883,1,310,615
"YKL190W","CNB1","Calcineurin B","Calcineurin B; regulatory subunit of calcineurin, a Ca++/calmodulin-regulated type 2B protein phosphatase which regulates Crz1p (stress-response transcription factor); other calcineurin subunit encoded by CNA1 and/or CMP1; regulates function of Aly1p alpha-arrestin; myristoylation by Nmt1p reduces calcineurin activity in response to submaximal Ca signals, is needed to prevent constitutive phosphatase activity; protein abundance increases in response to DNA replication stress","chrXI",82947,83550,1,"S000001673_C",75,82999,83074,1,53,128
"YKR004C","ECM9","Non-essential protein of unknown function","Non-essential protein of unknown function","chrXI",446799,448036,-1,"S000001712_C",103,447707,447810,-1,227,330
"YKR005C","","Putative protein of unknown function","Putative protein of unknown function","chrXI",448521,450167,-1,"S000001713_C",68,449952,450020,-1,148,216
"YKR057W","RPS21A","Protein component of the small (40S) ribosomal subunit","Protein component of the small (40S) ribosomal subunit; homologous to mammalian ribosomal protein S21, no bacterial homolog; RPS21A has a paralog, RPS21B, that arose from the whole genome duplication","chrXI",551657,552242,1,"S000001765_C",321,551681,552002,1,25,346
"YKR094C","RPL40B","Ubiquitin-ribosomal 60S subunit protein L40B fusion protein","Ubiquitin-ribosomal 60S subunit protein L40B fusion protein; cleaved to yield ubiquitin and ribosomal protein L40B; ubiquitin may facilitate assembly of the ribosomal protein into ribosomes; homologous to mammalian ribosomal protein L40, no bacterial homolog; RPL40B has a paralog, RPL40A, that arose from the whole genome duplication","chrXI",617996,618750,-1,"S000001802_C",367,618375,618742,-1,9,376
"YKR095W-A","PCC1","Component of the EKC/KEOPS protein complex","Component of the EKC/KEOPS protein complex; EKC/KEOPS complex is required for t6A tRNA modification and telomeric TG1-3 recombination; may have role in transcription; other complex members are Kae1p, Gon7p, Bud32p, and Cgi121p","chrXI",625864,626205,1,"S000028512_C",74,625902,625976,1,39,113
"YLL050C","COF1","Cofilin, involved in pH-dependent actin filament depolarization","Cofilin, involved in pH-dependent actin filament depolarization; binds both actin monomers and filaments and severs filaments; involved in the selective sorting, export of the secretory cargo from the late golgi; genetically interacts with pmr1; thought to be regulated by phosphorylation at SER4; ubiquitous and essential in eukaryotes","chrXII",39804,40414,-1,"S000003973_C",178,40222,40400,-1,15,193
"YLL066C","","Putative Y' element ATP-dependent helicase","Putative Y' element ATP-dependent helicase; YLL066C is not an essential gene","chrXII",6120,9836,-1,"S000003989_C",98,9451,9549,-1,288,386
"YLL067C","","Putative Y' element ATP-dependent helicase","Putative Y' element ATP-dependent helicase","chrXII",585,4301,-1,"S000003990_C",98,3916,4014,-1,288,386
"YLR048W","RPS0B","Protein component of the small (40S) ribosomal subunit","Protein component of the small (40S) ribosomal subunit; RPS0B has a paralog, RPS0A, that arose from the whole genome duplication; required for maturation of 18S rRNA along with Rps0Ap; deletion of either RPS0 gene reduces growth rate, deletion of both genes is lethal; homologous to human ribosomal protein SA and bacterial S2","chrXII",242232,243349,1,"S000004038_C",358,242322,242680,1,91,449
"YLR054C","OSW2","Protein of unknown function reputedly involved in spore wall assembly","Protein of unknown function reputedly involved in spore wall assembly","chrXII",248717,250978,-1,"S000004044_C",86,250861,250947,-1,32,118
"YLR061W","RPL22A","Ribosomal 60S subunit protein L22A","Ribosomal 60S subunit protein L22A; required for translation of long 5' UTR of IME1 mRNA and meiotic entry; required for the oxidative stress response, pseudohyphal and invasive growth; homologous to mammalian ribosomal protein L22, no bacterial homolog; RPL22A has a paralog, RPL22B, that arose from the whole genome duplication","chrXII",263194,263948,1,"S000004051_C",388,263206,263594,1,13,401
"YLR078C","BOS1","v-SNARE (vesicle specific SNAP receptor)","v-SNARE (vesicle specific SNAP receptor); localized to the endoplasmic reticulum membrane and necessary for vesicular transport from the ER to the Golgi; required for efficient nuclear fusion during mating","chrXII",285736,286559,-1,"S000004068_C",88,286468,286556,-1,4,92
"YLR093C","NYV1","v-SNARE component of the vacuolar SNARE complex","v-SNARE component of the vacuolar SNARE complex; involved in vesicle fusion; inhibits ATP-dependent Ca(2+) transport activity of Pmc1p in the vacuolar membrane","chrXII",326513,327415,-1,"S000004083_C",140,327259,327399,-1,17,157
"YLR128W","DCN1","Scaffold-type E3 ligase","Scaffold-type E3 ligase; required for cullin neddylation and ubiquitin ligase activation; contains a ubiquitin-binding domain (UBA) for ubiquitin and Nedd8 (Rub1p) interaction and a PONY domain involved in cullin binding and neddylation","chrXII",398530,399433,1,"S000004118_C",93,398533,398626,1,4,97
"YLR185W","RPL37A","Ribosomal 60S subunit protein L37A","Ribosomal 60S subunit protein L37A; required for processing of 27SB pre-rRNA and formation of stable 66S assembly intermediates; homologous to mammalian ribosomal protein L37, no bacterial homolog; RPL37A has a paralog, RPL37B, that arose from the whole genome duplication","chrXII",522663,523288,1,"S000004175_C",358,522670,523028,1,8,366
"YLR199C","PBA1","Protein involved in 20S proteasome assembly","Protein involved in 20S proteasome assembly; forms a heterodimer with Add66p that binds to proteasome precursors; interaction with Pba1p-Add66p may affect function of the mature proteasome and its role in maintaining respiratory metabolism; similar to human PAC1 constituent of the PAC1-PAC2 complex involved in proteasome assembly","chrXII",547853,548769,-1,"S000004189_C",85,548678,548763,-1,7,92
"YLR202C","","Dubious open reading frame","Dubious open reading frame; unlikely to encode a functional protein, based on available experimental and comparative sequence data; partially overlaps the verified ORF YLR201C; ORF contains a putative intron","chrXII",550194,550636,-1,"S000004192_C",115,550459,550574,-1,63,178
"YLR211C","ATG38","Homodimeric subunit of autophagy-specific PtdIns-3-kinase complex I","Homodimeric subunit of autophagy-specific PtdIns-3-kinase complex I; required for the integrity of the active PtdIns-3-kinase complex I by maintaining an association between Vps15p-Vps34p and Atg14p-Vps30p subcomplexes; localizes to the pre-autophagosomal structure (PAS) in an Atg14p-dependent manner; ATG38 is non-essential but is required for macroautophagy","chrXII",563792,564531,-1,"S000004201_C",58,564455,564513,-1,19,77
"YLR275W","SMD2","Core Sm protein Sm D2","Core Sm protein Sm D2; part of heteroheptameric complex (with Smb1p, Smd1p, Smd3p, Sme1p, Smx3p, and Smx2p) that is part of the spliceosomal U1, U2, U4, and U5 snRNPs; homolog of human Sm D2","chrXII",694378,694800,1,"S000004265_C",89,694383,694472,1,6,95
"YLR287C-A","RPS30A","Protein component of the small (40S) ribosomal subunit","Protein component of the small (40S) ribosomal subunit; homologous to mammalian ribosomal protein S30, no bacterial homolog; RPS30A has a paralog, RPS30B, that arose from the whole genome duplication","chrXII",712537,713158,-1,"S000004278_C",429,712726,713155,-1,4,433
"YLR306W","UBC12","Enzyme that mediates the conjugation of Rub1p","Enzyme that mediates the conjugation of Rub1p; a ubiquitin-like protein, to other proteins; related to E2 ubiquitin-conjugating enzymes","chrXII",744151,744851,1,"S000004297_C",133,744154,744287,1,4,137
"YLR316C","TAD3","Subunit of tRNA-specific adenosine-34 deaminase","Subunit of tRNA-specific adenosine-34 deaminase; forms a heterodimer with Tad2p that converts adenosine to inosine at the wobble position of several tRNAs","chrXII",765266,766358,-1,"S000004308_C",55,766074,766129,-1,230,285
"YLR316C","TAD3","Subunit of tRNA-specific adenosine-34 deaminase","Subunit of tRNA-specific adenosine-34 deaminase; forms a heterodimer with Tad2p that converts adenosine to inosine at the wobble position of several tRNAs","chrXII",765266,766358,-1,"S000004308_C",67,766182,766249,-1,110,177
"YLR329W","REC102","Protein involved in early stages of meiotic recombination","Protein involved in early stages of meiotic recombination; required for chromosome synapsis; forms a complex with Rec104p and Spo11p necessary during the initiation of recombination","chrXII",786442,787333,1,"S000004321_C",96,786616,786712,1,175,271
"YLR344W","RPL26A","Ribosomal 60S subunit protein L26A","Ribosomal 60S subunit protein L26A; binds to 5.8S rRNA; non-essential even when paralog is also deleted; deletion has minimal affections on ribosome biosynthesis; homologous to mammalian ribosomal protein L26 and bacterial L24; RPL26A has a paralog, RPL26B, that arose from the whole genome duplication","chrXII",819312,820142,1,"S000004336_C",446,819331,819777,1,20,466
"YLR367W","RPS22B","Protein component of the small (40S) ribosomal subunit","Protein component of the small (40S) ribosomal subunit; homologous to mammalian ribosomal protein S15A and bacterial S8; RPS22B has a paralog, RPS22A, that arose from the whole genome duplication","chrXII",856442,857317,1,"S000004359_C",482,856575,857057,1,134,616
"YLR406C","RPL31B","Ribosomal 60S subunit protein L31B","Ribosomal 60S subunit protein L31B; associates with karyopherin Sxm1p; loss of both Rpl31p and Rpl39p confers lethality; homologous to mammalian ribosomal protein L31, no bacterial homolog; RPL31B has a paralog, RPL31A, that arose from the whole genome duplication","chrXII",931065,931755,-1,"S000004398_C",348,931350,931698,-1,58,406
"YLR426W","TDA5","Putative protein of unknown function","Putative protein of unknown function; detected in highly purified mitochondria in high-throughput studies; proposed to be involved in resistance to mechlorethamine and streptozotocin; null mutant sensitive to expression of top1-T722A allele","chrXII",987062,988113,1,"S000004418_C",70,987142,987212,1,81,151
"YLR445W","GMC2","Protein involved in meiotic crossing over","Protein involved in meiotic crossing over; component of the Synaptonemal Complex (SC) along with Ecm11p; required for the efficient loading of the SC transverse filament protein, Zip1p; promotes SUMOylation of Ecm11p; mutants are delayed in meiotic nuclear division and are defective in synaptonemal complex assembly; transcription is regulated by Ume6p and induced in response to alpha factor","chrXII",1024189,1024837,1,"S000004437_C",81,1024573,1024654,1,385,466
"YLR448W","RPL6B","Ribosomal 60S subunit protein L6B","Ribosomal 60S subunit protein L6B; binds 5.8S rRNA; homologous to mammalian ribosomal protein L6, no bacterial homolog; RPL6B has a paralog, RPL6A, that arose from the whole genome duplication","chrXII",1028854,1029768,1,"S000004440_C",383,1028869,1029252,1,16,399
"YLR464W","","Putative protein of unknown function","Putative protein of unknown function; intron is predicted but not detected experimentally; YLR464W overlaps the verified gene YRF1-4/YLR466W and two dubious ORFs YLR463C and YLR465C","chrXII",1066572,1067501,1,"S000004456_C",278,1067085,1067363,1,514,792
"YML017W","PSP2","Asn rich cytoplasmic protein that contains RGG motifs","Asn rich cytoplasmic protein that contains RGG motifs; high-copy suppressor of group II intron-splicing defects of a mutation in MRS2 and of a conditional mutation in POL1 (DNA polymerase alpha); possible role in mitochondrial mRNA splicing","chrXIII",236588,238731,1,"S000004479_C",361,236592,236953,1,5,366
"YML024W","RPS17A","Ribosomal protein 51 (rp51) of the small (40s) subunit","Ribosomal protein 51 (rp51) of the small (40s) subunit; homologous to mammalian ribosomal protein S17, no bacterial homolog; RPS17A has a paralog, RPS17B, that arose from the whole genome duplication","chrXIII",225889,226697,1,"S000004486_C",397,225892,226289,1,4,401
"YML025C","YML6","Mitochondrial ribosomal protein of the large subunit","Mitochondrial ribosomal protein of the large subunit; has similarity to E. coli L4 ribosomal protein and human mitoribosomal MRP-L4 protein; essential for viability, unlike most other mitoribosomal proteins","chrXIII",224406,225365,-1,"S000004487_C",98,225240,225338,-1,28,126
"YML026C","RPS18B","Protein component of the small (40S) ribosomal subunit","Protein component of the small (40S) ribosomal subunit; homologous to mammalian ribosomal protein S18 and bacterial S13; RPS18B has a paralog, RPS18A, that arose from the whole genome duplication; protein abundance increases in response to DNA replication stress","chrXIII",222987,223828,-1,"S000004488_C",400,223381,223781,-1,48,448
"YML034W","SRC1","Inner nuclear membrane protein","Inner nuclear membrane protein; highly enriched at telomeres and subtelomeric regions; functions in regulation of subtelomeric genes and is linked to TREX (transcription export) factors; SRC1 produces 2 splice variant proteins with different functions; alternative splicing of SRC1 pre-mRNA is promoted by Hub1p; mutant has aneuploidy tolerance; SRC1 has a paralog, HEH2, that arose from the whole genome duplication","chrXIII",209525,212155,1,"S000004497_C",125,211445,211570,1,1921,2046
"YML036W","CGI121","Component of the EKC/KEOPS complex","Component of the EKC/KEOPS complex; EKC/KEOPS complex is required for t6A tRNA modification and telomeric TG1-3 recombination; may have role in transcription; Cgi121p is dispensable for tRNA modification; other complex members are Bud32p, Kae1p, Pcc1p, and Gon7p","chrXIII",205642,206293,1,"S000004500_C",105,206098,206203,1,457,562
"YML056C","IMD4","Inosine monophosphate dehydrogenase","Inosine monophosphate dehydrogenase; catalyzes the rate-limiting step in the de novo synthesis of GTP; member of a four-gene family in S. cerevisiae, constitutively expressed; IMD4 has a paralog, IMD3, that arose from the whole genome duplication","chrXIII",162194,164176,-1,"S000004520_C",407,163309,163716,-1,461,868
"YML067C","ERV41","Protein localized to COPII-coated vesicles","Protein localized to COPII-coated vesicles; forms a complex with Erv46p; involved in the membrane fusion stage of transport; has homology to human ERGIC2 (PTX1) protein","chrXIII",139063,140214,-1,"S000004532_C",92,140091,140183,-1,32,124
"YML073C","RPL6A","Ribosomal 60S subunit protein L6A","Ribosomal 60S subunit protein L6A; N-terminally acetylated; binds 5.8S rRNA; homologous to mammalian ribosomal protein L6, no bacterial homolog; RPL6A has a paralog, RPL6B, that arose from the whole genome duplication","chrXIII",123227,124172,-1,"S000004538_C",414,123743,124157,-1,16,430
"YML085C","TUB1","Alpha-tubulin","Alpha-tubulin; associates with beta-tubulin (Tub2p) to form tubulin dimer, which polymerizes to form microtubules; relative distribution to nuclear foci increases upon DNA replication stress; TUB1 has a paralog, TUB3, that arose from the whole genome duplication","chrXIII",97941,99400,-1,"S000004550_C",115,99260,99375,-1,26,141
"YML094W","GIM5","Subunit of the heterohexameric cochaperone prefoldin complex","Subunit of the heterohexameric cochaperone prefoldin complex; prefoldin binds specifically to cytosolic chaperonin and transfers target proteins to it; prefoldin complex also localizes to chromatin of actively transcribed genes in the nucleus and facilitates transcriptional elongation","chrXIII",82275,82849,1,"S000004559_C",82,82291,82373,1,17,99
"YML124C","TUB3","Alpha-tubulin","Alpha-tubulin; associates with beta-tubulin (Tub2p) to form tubulin dimer, which polymerizes to form microtubules; expressed at lower level than Tub1p; TUB3 has a paralog, TUB1, that arose from the whole genome duplication","chrXIII",22048,23683,-1,"S000004593_C",297,23361,23658,-1,26,323
"YML133C","","Putative Y' element ATP-dependent helicase","Putative Y' element ATP-dependent helicase; the authentic, non-tagged protein is detected in highly purified mitochondria in high-throughput studies; YML133C contains an intron","chrXIII",461,4684,-1,"S000004602_C",98,3792,3890,-1,795,893
"YMR033W","ARP9","Component of both the SWI/SNF and RSC chromatin remodeling complexes","Component of both the SWI/SNF and RSC chromatin remodeling complexes; actin-related protein involved in transcriptional regulation","chrXIII",337788,339277,1,"S000004636_C",85,337818,337903,1,31,116
"YMR079W","SEC14","Phosphatidylinositol/phosphatidylcholine transfer protein","Phosphatidylinositol/phosphatidylcholine transfer protein; involved in regulating PtdIns, PtdCho, and ceramide metabolism, products of which regulate intracellular transport and UPR; has a role in localization of lipid raft proteins; functionally homologous to mammalian PITPs; SEC14 has a paralog, YKL091C, that arose from the whole genome duplication","chrXIII",424989,426059,1,"S000004684_C",155,424998,425153,1,10,165
"YMR116C","ASC1","G-protein beta subunit and guanine dissociation inhibitor for Gpa2p","G-protein beta subunit and guanine dissociation inhibitor for Gpa2p; ortholog of RACK1 that inhibits translation; core component of the small (40S) ribosomal subunit; required to prevent frameshifting at ribosomes stalled at repeated CGA codons; regulates P-body formation induced by replication stress; represses Gcn4p in the absence of amino acid starvation; controls phosphorylation of multiple proteins","chrXIII",499456,500688,-1,"S000004722_C",272,499879,500151,-1,538,810
"YMR125W","STO1","Large subunit of the nuclear mRNA cap-binding protein complex","Large subunit of the nuclear mRNA cap-binding protein complex; interacts with Npl3p to carry nuclear poly(A)+ mRNA to cytoplasm; also involved in nuclear mRNA degradation and telomere maintenance; orthologous to mammalian CBP80","chrXIII",517539,520446,1,"S000004732_C",321,517564,517885,1,26,347
"YMR133W","REC114","Protein involved in early stages of meiotic recombination","Protein involved in early stages of meiotic recombination; possibly involved in the coordination of recombination and meiotic division; mutations lead to premature initiation of the first meiotic division","chrXIII",536207,537609,1,"S000004740_C",115,537449,537564,1,1243,1358
"YMR142C","RPL13B","Ribosomal 60S subunit protein L13B","Ribosomal 60S subunit protein L13B; not essential for viability; homologous to mammalian ribosomal protein L13, no bacterial homolog; RPL13B has a paralog, RPL13A, that arose from the whole genome duplication","chrXIII",550206,551207,-1,"S000004750_C",401,550802,551203,-1,5,406
"YMR143W","RPS16A","Protein component of the small (40S) ribosomal subunit","Protein component of the small (40S) ribosomal subunit; homologous to mammalian ribosomal protein S16 and bacterial S9; RPS16A has a paralog, RPS16B, that arose from the whole genome duplication","chrXIII",551928,552903,1,"S000004751_C",543,551952,552495,1,25,568
"YMR147W","LDO45","Putative protein of unknown function","Putative protein of unknown function; SWAT-GFP and mCherry fusion proteins localize to the cell periphery","chrXIII",559199,560812,1,"S000004755_C",374,559781,560155,1,583,957
"YMR194C-B","CMC4","Protein that localizes to the mitochondrial intermembrane space","Protein that localizes to the mitochondrial intermembrane space; localizes via the Mia40p-Erv1p system; contains twin cysteine-x(9)-cysteine motifs","chrXIII",652594,652887,-1,"S000028514_C",71,652776,652847,-1,41,112
"YMR194W","RPL36A","Ribosomal 60S subunit protein L36A","Ribosomal 60S subunit protein L36A; N-terminally acetylated; binds to 5.8 S rRNA; homologous to mammalian ribosomal protein L36, no bacterial homolog; RPL36A has a paralog, RPL36B, that arose from the whole genome duplication","chrXIII",651145,651910,1,"S000004807_C",462,651161,651623,1,17,479
"YMR201C","RAD14","Subunit of Nucleotide Excision Repair Factor 1 (NEF1)","Subunit of Nucleotide Excision Repair Factor 1 (NEF1); recognizes and binds damaged DNA during nucleotide excision repair (NER); also involved in regulation of transcription; contains zinc finger motif; homolog of human XPA protein","chrXIII",665845,667044,-1,"S000004814_C",83,666934,667017,-1,28,111
"YMR225C","MRPL44","Mitochondrial ribosomal protein of the large subunit","Mitochondrial ribosomal protein of the large subunit; protein abundance increases in response to DNA replication stress","chrXIII",720960,721403,-1,"S000004838_C",146,721199,721345,-1,59,205
"YMR230W","RPS10B","Protein component of the small (40S) ribosomal subunit","Protein component of the small (40S) ribosomal subunit; homologous to mammalian ribosomal protein S10, no bacterial homolog; RPS10B has a paralog, RPS10A, that arose from the whole genome duplication; mutations in the human homolog associated with Diamond-Blackfan anemia","chrXIII",732414,733141,1,"S000004843_C",409,732466,732875,1,53,462
"YMR242C","RPL20A","Ribosomal 60S subunit protein L20A","Ribosomal 60S subunit protein L20A; homologous to mammalian ribosomal protein L18A, no bacterial homolog; RPL20A has a paralog, RPL20B, that arose from the whole genome duplication","chrXIII",753225,754220,-1,"S000004855_C",476,753743,754219,-1,2,478
"YMR292W","GOT1","Homodimeric protein that is packaged into COPII vesicles","Homodimeric protein that is packaged into COPII vesicles; cycles between the ER and Golgi; involved in secretory transport but not directly required for aspects of transport assayed in vitro; may influence membrane composition","chrXIII",854795,855293,1,"S000004906_C",81,854817,854898,1,23,104
"YNL004W","HRB1","Poly(A+) RNA-binding protein","Poly(A+) RNA-binding protein; key surveillance factor for the selective export of spliced mRNAs from the nucleus to the cytoplasm; preference for intron-containing genes; similar to Npl3p; HRB1 has a paralog, GBP2, that arose from the whole genome duplication","chrXIV",622915,624621,1,"S000004949_C",341,622945,623286,1,31,372
"YNL012W","SPO1","Meiosis-specific prospore protein","Meiosis-specific prospore protein; required for meiotic spindle pole body duplication and separation; required to produce bending force necessary for proper prospore membrane assembly during sporulation; has similarity to phospholipase B","chrXIV",609686,611665,1,"S000004957_C",83,609791,609874,1,106,189
"YNL038W","GPI15","Protein involved in the synthesis of GlcNAc-PI","Protein involved in the synthesis of GlcNAc-PI; GlcNAc-PI is the first intermediate in the synthesis of glycosylphosphatidylinositol (GPI) anchors; homologous to the human PIG-H protein; GlcNAc-PI stands for N-acetylglucosaminyl phosphatidylinositol","chrXIV",557020,557783,1,"S000004983_C",73,557611,557684,1,592,665
"YNL044W","YIP3","Protein localized to COPII vesicles","Protein localized to COPII vesicles; proposed to be involved in ER to Golgi transport; interacts with members of the Rab GTPase family and Yip1p; also interacts with Rtn1p","chrXIV",545268,545877,1,"S000004989_C",78,545292,545370,1,25,103
"YNL050C","","Putative protein of unknown function","Putative protein of unknown function; YNL050c is not an essential gene","chrXIV",534079,534982,-1,"S000004995_C",90,534875,534965,-1,18,108
"YNL069C","RPL16B","Ribosomal 60S subunit protein L16B","Ribosomal 60S subunit protein L16B; N-terminally acetylated, binds 5.8 S rRNA; transcriptionally regulated by Rap1p; homologous to mammalian ribosomal protein L13A and bacterial L13; RPL16B has a paralog, RPL16A, that arose from the whole genome duplication","chrXIV",493956,495001,-1,"S000005013_C",448,494525,494973,-1,29,477
"YNL096C","RPS7B","Protein component of the small (40S) ribosomal subunit","Protein component of the small (40S) ribosomal subunit; interacts with Kti11p; deletion causes hypersensitivity to zymocin; homologous to mammalian ribosomal protein S7, no bacterial homolog; RPS7B has a paralog, RPS7A, that arose from the whole genome duplication; protein abundance increases in response to DNA replication stress","chrXIV",443398,444315,-1,"S000005040_C",344,443827,444171,-1,145,489
"YNL112W","DBP2","ATP-dependent RNA helicase of the DEAD-box protein family","ATP-dependent RNA helicase of the DEAD-box protein family; has strong preference for dsRNA; remodels RNA-protein complex (RNP) to facilitate efficient transcription termination ; required for assembly of Yra1p, Nab2p and Mex67p onto mRNA and formation of nuclear mRNP; involved in mRNA decay and rRNA processing; may be involved in suppression of transcription from cryptic initiation sites","chrXIV",413639,416281,1,"S000005056_C",1001,414912,415913,1,1274,2275
"YNL130C","CPT1","Cholinephosphotransferase","Cholinephosphotransferase; required for phosphatidylcholine biosynthesis and for inositol-dependent regulation of EPT1 transcription; CPT1 has a paralog, EPT1, that arose from the whole genome duplication","chrXIV",379558,380831,-1,"S000005074_C",91,380690,380781,-1,51,142
"YNL138W-A","YSF3","Component of the SF3b subcomplex of the U2 snRNP","Component of the SF3b subcomplex of the U2 snRNP; essential protein required for splicing and for assembly of SF3b","chrXIV",366033,366412,1,"S000028509_C",121,366036,366157,1,4,125
"YNL147W","LSM7","Lsm (Like Sm) protein","Lsm (Like Sm) protein; part of heteroheptameric complexes (Lsm2p-7p and either Lsm1p or 8p): cytoplasmic Lsm1p complex involved in mRNA decay; nuclear Lsm8p complex part of U6 snRNP and possibly involved in processing tRNA, snoRNA, and rRNA; protein abundance increases and forms cytoplasmic foci in response to DNA replication stress","chrXIV",350940,351383,1,"S000005091_C",95,350958,351053,1,19,114
"YNL162W","RPL42A","Ribosomal 60S subunit protein L42A","Ribosomal 60S subunit protein L42A; homologous to mammalian ribosomal protein L36A, no bacterial homolog; RPL42A has a paralog, RPL42B, that arose from the whole genome duplication","chrXIV",331322,332154,1,"S000005106_C",511,331326,331837,1,5,516
"YNL246W","VPS75","NAP family histone chaperone","NAP family histone chaperone; binds to histones and Rtt109p, stimulating histone acetyltransferase activity; possesses nucleosome assembly activity in vitro; proposed role in vacuolar protein sorting and in double-strand break repair; protein abundance increases in response to DNA replication stress; relocalizes to the cytosol in response to hypoxia","chrXIV",185460,186349,1,"S000005190_C",94,185492,185586,1,33,127
"YNL265C","IST1","Protein with positive role in the multivesicular body sorting pathway","Protein with positive role in the multivesicular body sorting pathway; functions and forms a complex with Did2p; recruitment to endosomes is mediated by the Vps2p-Vps24p subcomplex of ESCRT-III; also interacts with Vps4p","chrXIV",144280,145281,-1,"S000005209_C",104,145150,145254,-1,28,132
"YNL301C","RPL18B","Ribosomal 60S subunit protein L18B","Ribosomal 60S subunit protein L18B; homologous to mammalian ribosomal protein L18, no bacterial homolog; RPL18B has a paralog, RPL18A, that arose from the whole genome duplication","chrXIV",63570,64562,-1,"S000005245_C",431,64019,64450,-1,113,544
"YNL302C","RPS19B","Protein component of the small (40S) ribosomal subunit","Protein component of the small (40S) ribosomal subunit; required for assembly and maturation of pre-40 S particles; homologous to mammalian ribosomal protein S19, no bacterial homolog; mutations in human RPS19 are associated with Diamond Blackfan anemia; RPS19B has a paralog, RPS19A, that arose from the whole genome duplication","chrXIV",61958,62943,-1,"S000005246_C",550,62373,62923,-1,21,571
"YNL312W","RFA2","Subunit of heterotrimeric Replication Protein A (RPA)","Subunit of heterotrimeric Replication Protein A (RPA); RPA is a highly conserved single-stranded DNA binding protein involved in DNA replication, repair, and recombination; RPA protects against inappropriate telomere recombination, and upon telomere uncapping, prevents cell proliferation by a checkpoint-independent pathway; in concert with Sgs1p-Top2p-Rmi1p, stimulates DNA catenation/decatenation activity of Top3p; protein abundance increases in response to DNA replication s","chrXIV",48287,49216,1,"S000005256_C",107,48294,48401,1,8,115
"YNL339C","YRF1-6","Helicase encoded by the Y' element of subtelomeric regions","Helicase encoded by the Y' element of subtelomeric regions; highly expressed in the mutants lacking the telomerase component TLC1; potentially phosphorylated by Cdc28p","chrXIV",371,6098,-1,"S000005283_C",147,5932,6079,-1,20,167
"YNR053C","NOG2","Putative GTPase","Putative GTPase; associates with pre-60S ribosomal subunits in the nucleolus and is required for their nuclear export and maturation; recruited by ribosomal proteins L17, L35, and L37 to assembling ribosomes after 27SB pre-rRNA is generated, immediately preceding removal of ITS2","chrXIV",721120,723112,-1,"S000005336_C",531,721771,722302,-1,811,1342
"YOL047C","LDS2","Protein Involved in spore wall assembly","Protein Involved in spore wall assembly; localizes to lipid droplets found on or outside of the prospore membrane; shares similarity with Lds1p and Rrt8p, and a strain mutant for all 3 genes exhibits reduced dityrosine fluorescence relative to the single mutants; green fluorescent protein (GFP)-fusion protein localizes to the cytoplasm in a punctate pattern","chrXV",241614,242747,-1,"S000005407_C",62,242442,242504,-1,244,306
"YOL048C","RRT8","Protein involved in spore wall assembly","Protein involved in spore wall assembly; shares similarity with Lds1p and Lds2p and a strain mutant for all 3 genes exhibits reduced dityrosine fluorescence relative to the single mutants; identified in a screen for mutants with increased levels of rDNA transcription; green fluorescent protein (GFP)-fusion protein localizes to lipid particles; protein abundance increases in response to DNA replication stress","chrXV",240204,241310,-1,"S000005408_C",77,240948,241025,-1,286,363
"YOL120C","RPL18A","Ribosomal 60S subunit protein L18A","Ribosomal 60S subunit protein L18A; intron of RPL18A pre-mRNA forms stem-loop structures that are a target for Rnt1p cleavage leading to degradation; homologous to mammalian ribosomal protein L18, no bacterial homolog; RPL18A has a paralog, RPL18B, that arose from the whole genome duplication","chrXV",93395,94402,-1,"S000005480_C",446,93844,94290,-1,113,559
"YOL121C","RPS19A","Protein component of the small (40S) ribosomal subunit","Protein component of the small (40S) ribosomal subunit; required for assembly and maturation of pre-40 S particles; homologous to mammalian ribosomal protein S19, no bacterial homolog; mutations in human RPS19 are associated with Diamond Blackfan anemia; RPS19A has a paralog, RPS19B, that arose from the whole genome duplication","chrXV",92026,92850,-1,"S000005481_C",389,92441,92830,-1,21,410
"YOL127W","RPL25","Ribosomal 60S subunit protein L25","Ribosomal 60S subunit protein L25; primary rRNA-binding ribosomal protein component of large ribosomal subunit; binds to 25S rRNA via a conserved C-terminal motif; homologous to mammalian ribosomal protein L23A and bacterial L23","chrXV",80348,81190,1,"S000005487_C",413,80361,80774,1,14,427
"YOR096W","RPS7A","Protein component of the small (40S) ribosomal subunit","Protein component of the small (40S) ribosomal subunit; interacts with Kti11p; deletion causes hypersensitivity to zymocin; homologous to mammalian ribosomal protein S7, no bacterial homolog; RPS7A has a paralog, RPS7B, that arose from the whole genome duplication","chrXV",505794,506767,1,"S000005622_C",400,505938,506338,1,145,545
"YOR122C","PFY1","Profilin","Profilin; binds actin, phosphatidylinositol 4,5-bisphosphate, and polyproline regions; involved in cytoskeleton organization; required for normal timing of actin polymerization in response to thermal stress; protein abundance increases in response to DNA replication stress; highly conserved protein; human PFN1 (profilin 1) complements temperature sensitive pfy1 mutants, PFN1 mutations are a rare cause of ALS","chrXV",552298,552887,-1,"S000005648_C",208,552666,552874,-1,14,222
"YOR182C","RPS30B","Protein component of the small (40S) ribosomal subunit","Protein component of the small (40S) ribosomal subunit; homologous to mammalian ribosomal protein S30, no bacterial homolog; RPS30B has a paralog, RPS30A, that arose from the whole genome duplication; protein abundance increases in response to DNA replication stress","chrXV",678191,678793,-1,"S000005708_C",410,678380,678790,-1,4,414
"YOR234C","RPL33B","Ribosomal 60S subunit protein L33B","Ribosomal 60S subunit protein L33B; rpl33b null mutant exhibits normal growth while rpl33a rpl33b double null mutant is inviable; homologous to mammalian ribosomal protein L35A, no bacterial homolog; RPL33B has a paralog, RPL33A, that arose from the whole genome duplication","chrXV",778555,779405,-1,"S000005760_C",526,778860,779386,-1,20,546
"YOR293W","RPS10A","Protein component of the small (40S) ribosomal subunit","Protein component of the small (40S) ribosomal subunit; homologous to mammalian ribosomal protein S10, no bacterial homolog; RPS10A has a paralog, RPS10B, that arose from the whole genome duplication; mutations in the human homolog associated with Diamond-Blackfan anemia","chrXV",867098,867852,1,"S000005819_C",436,867150,867586,1,53,489
"YOR312C","RPL20B","Ribosomal 60S subunit protein L20B","Ribosomal 60S subunit protein L20B; homologous to mammalian ribosomal protein L18A, no bacterial homolog; RPL20B has a paralog, RPL20A, that arose from the whole genome duplication","chrXV",900250,901194,-1,"S000005839_C",425,900768,901193,-1,2,427
"YOR318C","","Dubious open reading frame","Dubious open reading frame; unlikely to encode a functional protein, based on available experimental and comparative sequence data; transcript is predicted to be spliced but there is no evidence that it is spliced in vivo","chrXV",911784,912436,-1,"S000005845_C",346,912086,912432,-1,5,351
"YPL031C","PHO85","Cyclin-dependent kinase","Cyclin-dependent kinase; has ten cyclin partners; involved in regulating the cellular response to nutrient levels and environmental conditions and progression through the cell cycle; human lissencephaly-associated homolog CDK5 functionally complements null mutation","chrXVI",492018,493037,-1,"S000005952_C",101,492919,493020,-1,18,119
"YPL075W","GCR1","Transcriptional activator of genes involved in glycolysis","Transcriptional activator of genes involved in glycolysis; DNA-binding protein that interacts and functions with the transcriptional activator Gcr2p; contains a long intron, which allows multiple RNA and protein isoforms with varying expression levels depending on glucose availability","chrXVI",412254,415362,1,"S000005996_C",750,412262,413012,1,9,759
"YPL079W","RPL21B","Ribosomal 60S subunit protein L21B","Ribosomal 60S subunit protein L21B; homologous to mammalian ribosomal protein L21, no bacterial homolog; RPL21B has a paralog, RPL21A, that arose from the whole genome duplication","chrXVI",406636,407539,1,"S000006000_C",420,406647,407067,1,12,432
"YPL081W","RPS9A","Protein component of the small (40S) ribosomal subunit","Protein component of the small (40S) ribosomal subunit; homologous to mammalian ribosomal protein S9 and bacterial S4; RPS9A has a paralog, RPS9B, that arose from the whole genome duplication","chrXVI",404950,406044,1,"S000006002_C",500,404957,405457,1,8,508
"YPL090C","RPS6A","Protein component of the small (40S) ribosomal subunit","Protein component of the small (40S) ribosomal subunit; homologous to mammalian ribosomal protein S6, no bacterial homolog; phosphorylated on S233 by Ypk3p in a TORC1-dependent manner, and on S232 in a TORC1/2-dependent manner by Ypk1/2/3p; RPS6A has a paralog, RPS6B, that arose from the whole genome duplication","chrXVI",377291,378395,-1,"S000006011_C",393,377996,378389,-1,7,400
"YPL109C","MCO76","UbiB family mitochondrial protein","UbiB family mitochondrial protein; contains transmembrane domain and mitochondrial targeting sequence; the authentic, non-tagged protein is detected in highly purified mitochondria in high-throughput studies","chrXVI",345264,347389,-1,"S000006030_C",151,345445,345596,-1,1794,1945
"YPL129W","TAF14","Subunit of TFIID, TFIIF, INO80, SWI/SNF, and NuA3 complexes","Subunit of TFIID, TFIIF, INO80, SWI/SNF, and NuA3 complexes; involved in RNA polymerase II transcription initiation and in chromatin modification; contains a YEATS domain","chrXVI",305298,306137,1,"S000006050_C",104,305307,305411,1,10,114
"YPL143W","RPL33A","Ribosomal 60S subunit protein L33A","Ribosomal 60S subunit protein L33A; N-terminally acetylated; rpl33a null mutant exhibits slow growth while rpl33a rpl33b double null mutant is inviable; homologous to mammalian ribosomal protein L35A, no bacterial homolog; RPL33A has a paralog, RPL33B, that arose from the whole genome duplication","chrXVI",282122,282970,1,"S000006064_C",524,282141,282665,1,20,544
"YPL175W","SPT14","UDP-glycosyltransferase subunit of the GPI-GnT complex","UDP-glycosyltransferase subunit of the GPI-GnT complex; UDP-GlcNAc-binding and catalytic subunit of the enzyme that mediates the first step in glycosylphosphatidylinositol (GPI) biosynthesis, mutations cause defects in transcription and in biogenesis of cell wall proteins","chrXVI",218630,220088,1,"S000006096_C",99,218647,218746,1,18,117
"YPL198W","RPL7B","Ribosomal 60S subunit protein L7B","Ribosomal 60S subunit protein L7B; required for processing of 27SA3 pre-rRNA to 27SB pre-rRNA during assembly of large ribosomal subunit; depletion leads to a turnover of pre-rRNA; contains a conserved C-terminal Nucleic acid Binding Domain (NDB2); binds to Domain II of 25S and 5.8S rRNAs; homologous to mammalian ribosomal protein L7 and bacterial L30; RPL7B has a paralog, RPL7A, that arose from the whole genome duplication","chrXVI",173152,174702,1,"S000006119_C",406,173666,174072,1,515,921
"YPL198W","RPL7B","Ribosomal 60S subunit protein L7B","Ribosomal 60S subunit protein L7B; required for processing of 27SA3 pre-rRNA to 27SB pre-rRNA during assembly of large ribosomal subunit; depletion leads to a turnover of pre-rRNA; contains a conserved C-terminal Nucleic acid Binding Domain (NDB2); binds to Domain II of 25S and 5.8S rRNAs; homologous to mammalian ribosomal protein L7 and bacterial L30; RPL7B has a paralog, RPL7A, that arose from the whole genome duplication","chrXVI",173152,174702,1,"S000006119_C",408,173163,173571,1,12,420
"YPL218W","SAR1","ARF family GTPase","ARF family GTPase; component of the COPII vesicle coat; required for transport vesicle formation during ER to Golgi protein transport; lowers membrane rigidity aiding vesicle formation; localizes to ER-mitochondrial contact sites where it enhances membrane curvature, thereby reducing contact size via its N-terminal amphipathic helix; regulates mitochondrial fission and fusion dynamics","chrXVI",138698,139409,1,"S000006139_C",138,138726,138864,1,29,167
"YPL241C","CIN2","GTPase-activating protein (GAP) for Cin4p","GTPase-activating protein (GAP) for Cin4p; tubulin folding factor C involved in beta-tubulin (Tub2p) folding; mutants display increased chromosome loss and benomyl sensitivity; human homolog RP2 complements yeast null mutant","chrXVI",95372,96258,-1,"S000006162_C",79,96154,96233,-1,26,105
"YPL249C-A","RPL36B","Ribosomal 60S subunit protein L36B","Ribosomal 60S subunit protein L36B; binds to 5.8 S rRNA; homologous to mammalian ribosomal protein L36, no bacterial homolog; RPL36B has a paralog, RPL36A, that arose from the whole genome duplication","chrXVI",75699,76239,-1,"S000006438_C",237,75986,76223,-1,17,254
"YPL283C","YRF1-7","Helicase encoded by the Y' element of subtelomeric regions","Helicase encoded by the Y' element of subtelomeric regions; highly expressed in the mutants lacking the telomerase component TLC1; potentially phosphorylated by Cdc28p","chrXVI",280,6007,-1,"S000006204_C",147,5841,5988,-1,20,167
"YPR010C-A","MIN8","Protein of unknown function","Protein of unknown function; SWAT-GFP, seamless-GFP and mCherry fusion proteins localize to cytosol; conserved among Saccharomyces sensu stricto species","chrXVI",582373,582734,-1,"S000122558_C",142,582559,582701,-1,34,176
"YPR028W","YOP1","Reticulon-interacting protein","Reticulon-interacting protein; ER integral membrane protein involved in the generation of tubular ER morphology; promotes membrane curvature; forms tubules in vitro; regulates the ER asymmetry-induced inheritance block during ER stress; role in ER-derived peroxisomal biogenesis; interacts with Yip1p to mediate membrane traffic and with Sey1p to maintain ER morphology; facilitates lipid exchange between the ER and mitochondria; forms ER foci upon DNA replication stress","chrXVI",623527,624202,1,"S000006232_C",132,623578,623710,1,52,184
"YPR043W","RPL43A","Ribosomal 60S subunit protein L43A","Ribosomal 60S subunit protein L43A; null mutation confers a dominant lethal phenotype; homologous to mammalian ribosomal protein L37A, no bacterial homolog; RPL43A has a paralog, RPL43B, that arose from the whole genome duplication","chrXVI",654166,654847,1,"S000006247_C",402,654168,654570,1,3,405
"YPR063C","","ER-localized protein of unknown function","ER-localized protein of unknown function","chrXVI",677812,678320,-1,"S000006267_C",85,678194,678279,-1,42,127
"YPR098C","TMH18","Mitochondrial protein of unknown function","Mitochondrial protein of unknown function; localized to the mitochondrial outer membrane","chrXVI",728947,729528,-1,"S000006302_C",95,729386,729481,-1,48,143
"YPR132W","RPS23B","Ribosomal protein 28 (rp28) of the small (40S) ribosomal subunit","Ribosomal protein 28 (rp28) of the small (40S) ribosomal subunit; required for translational accuracy; homologous to mammalian ribosomal protein S23 and bacterial S12; RPS23B has a paralog, RPS23A, that arose from the whole genome duplication; deletion of both RPS23A and RPS23B is lethal","chrXVI",794965,795767,1,"S000006336_C",364,795030,795394,1,66,430
"YPR153W","24-May","ER-associated high-pressure growth gene","ER-associated high-pressure growth gene; ER chaperone for nutrient permeases","chrXVI",833689,834245,1,"S000006357_C",133,833694,833827,1,6,139
"YPR170W-B","","Putative, non-essential component vacuolar ATPase","Putative, non-essential component vacuolar ATPase; conserved in fungi; SWAT-GFP fusion protein localizes to vacuole membrane; partially overlaps the dubious genes YPR169W-A, YPR170W-A and YRP170C","chrXVI",883239,883595,1,"S000028515_C",98,883388,883486,1,150,248
"YPR187W","RPO26","RNA polymerase subunit ABC23","RNA polymerase subunit ABC23; common to RNA polymerases I, II, and III; part of central core; similar to bacterial omega subunit","chrXVI",911257,911800,1,"S000006391_C",75,911277,911352,1,21,96
"YPR202W","","Putative protein of unknown function","Putative protein of unknown function; similar to telomere-encoded helicases; down-regulated at low calcium levels; YPR202W is not an essential gene; transcript is predicted to be spliced but there is no evidence that it is spliced in vivo","chrXVI",943032,943896,1,"S000006406_C",147,943051,943198,1,20,167
